,pid,act,start,end,duration
0,0,home,0,390,390
1,0,shop,390,420,30
2,0,work,420,960,540
3,0,leisure,960,1095,135
4,0,home,1095,1440,345
5,1,home,0,390,390
6,1,shop,390,420,30
7,1,education,420,540,120
8,1,work,540,960,420
9,1,leisure,960,1020,60
10,1,home,1020,1440,420
11,2,home,0,375,375
12,2,work,375,795,420
13,2,education,795,945,150
14,2,leisure,945,1020,75
15,2,home,1020,1440,420
16,3,home,0,390,390
17,3,work,390,1005,615
18,3,education,1005,1080,75
19,3,home,1080,1440,360
20,4,home,0,375,375
21,4,shop,375,405,30
22,4,work,405,945,540
23,4,leisure,945,1005,60
24,4,home,1005,1440,435
25,5,home,0,375,375
26,5,shop,375,390,15
27,5,education,390,480,90
28,5,work,480,930,450
29,5,leisure,930,1020,90
30,5,home,1020,1440,420
31,6,home,0,405,405
32,6,leisure,405,450,45
33,6,work,450,960,510
34,6,leisure,960,1080,120
35,6,home,1080,1440,360
36,7,home,0,390,390
37,7,leisure,390,405,15
38,7,work,405,990,585
39,7,education,990,1080,90
40,7,home,1080,1440,360
41,8,home,0,390,390
42,8,work,390,930,540
43,8,shop,930,960,30
44,8,home,960,1440,480
45,9,home,0,375,375
46,9,shop,375,435,60
47,9,work,435,975,540
48,9,leisure,975,1050,75
49,9,home,1050,1440,390
50,10,home,0,375,375
51,10,shop,375,390,15
52,10,work,390,990,600
53,10,education,990,1080,90
54,10,home,1080,1440,360
55,11,home,0,375,375
56,11,leisure,375,435,60
57,11,work,435,990,555
58,11,education,990,1080,90
59,11,home,1080,1440,360
60,12,home,0,405,405
61,12,work,405,990,585
62,12,shop,990,1005,15
63,12,home,1005,1140,135
64,12,shop,1140,1155,15
65,12,home,1155,1440,285
66,13,home,0,390,390
67,13,work,390,1005,615
68,13,leisure,1005,1065,60
69,13,home,1065,1440,375
70,14,home,0,375,375
71,14,work,375,960,585
72,14,leisure,960,1050,90
73,14,home,1050,1440,390
74,15,home,0,375,375
75,15,work,375,915,540
76,15,shop,915,960,45
77,15,home,960,1230,270
78,15,leisure,1230,1290,60
79,15,home,1290,1440,150
80,16,home,0,405,405
81,16,work,405,975,570
82,16,leisure,975,1035,60
83,16,home,1035,1440,405
84,17,home,0,390,390
85,17,shop,390,405,15
86,17,work,405,825,420
87,17,education,825,975,150
88,17,home,975,1440,465
89,18,home,0,375,375
90,18,shop,375,390,15
91,18,work,390,825,435
92,18,education,825,975,150
93,18,leisure,975,1035,60
94,18,shop,1035,1050,15
95,18,home,1050,1440,390
96,19,home,0,405,405
97,19,shop,405,465,60
98,19,work,465,915,450
99,19,leisure,915,1005,90
100,19,home,1005,1440,435
101,20,home,0,390,390
102,20,shop,390,450,60
103,20,work,450,990,540
104,20,education,990,1080,90
105,20,home,1080,1440,360
106,21,home,0,375,375
107,21,work,375,810,435
108,21,education,810,930,120
109,21,shop,930,960,30
110,21,home,960,1440,480
111,22,home,0,405,405
112,22,leisure,405,420,15
113,22,work,420,960,540
114,22,shop,960,975,15
115,22,home,975,1440,465
116,23,home,0,375,375
117,23,work,375,810,435
118,23,education,810,930,120
119,23,shop,930,960,30
120,23,home,960,1440,480
121,24,home,0,390,390
122,24,shop,390,435,45
123,24,work,435,1005,570
124,24,leisure,1005,1065,60
125,24,home,1065,1440,375
126,25,home,0,405,405
127,25,shop,405,420,15
128,25,work,420,945,525
129,25,leisure,945,1035,90
130,25,home,1035,1440,405
131,26,home,0,435,435
132,26,work,435,915,480
133,26,shop,915,960,45
134,26,home,960,1440,480
135,27,home,0,390,390
136,27,shop,390,420,30
137,27,work,420,915,495
138,27,shop,915,960,45
139,27,home,960,1200,240
140,27,leisure,1200,1275,75
141,27,home,1275,1440,165
142,28,home,0,375,375
143,28,shop,375,435,60
144,28,work,435,975,540
145,28,education,975,1080,105
146,28,home,1080,1440,360
147,29,home,0,375,375
148,29,work,375,915,540
149,29,leisure,915,1005,90
150,29,home,1005,1440,435
151,30,home,0,375,375
152,30,shop,375,390,15
153,30,education,390,465,75
154,30,work,465,1020,555
155,30,leisure,1020,1080,60
156,30,home,1080,1440,360
157,31,home,0,420,420
158,31,work,420,960,540
159,31,shop,960,975,15
160,31,home,975,1185,210
161,31,leisure,1185,1245,60
162,31,home,1245,1440,195
163,32,home,0,390,390
164,32,work,390,825,435
165,32,education,825,975,150
166,32,home,975,1440,465
167,33,home,0,405,405
168,33,work,405,930,525
169,33,leisure,930,990,60
170,33,shop,990,1005,15
171,33,home,1005,1440,435
172,34,home,0,390,390
173,34,shop,390,435,45
174,34,work,435,975,540
175,34,education,975,1080,105
176,34,home,1080,1440,360
177,35,home,0,405,405
178,35,work,405,900,495
179,35,shop,900,960,60
180,35,home,960,1440,480
181,36,home,0,390,390
182,36,shop,390,420,30
183,36,leisure,420,480,60
184,36,work,480,990,510
185,36,education,990,1080,90
186,36,home,1080,1440,360
187,37,home,0,375,375
188,37,shop,375,405,30
189,37,work,405,990,585
190,37,education,990,1080,90
191,37,home,1080,1440,360
192,38,home,0,390,390
193,38,shop,390,420,30
194,38,work,420,915,495
195,38,leisure,915,990,75
196,38,home,990,1440,450
197,39,home,0,375,375
198,39,shop,375,390,15
199,39,work,390,960,570
200,39,leisure,960,1020,60
201,39,home,1020,1440,420
202,40,home,0,390,390
203,40,work,390,915,525
204,40,leisure,915,990,75
205,40,home,990,1440,450
206,41,home,0,375,375
207,41,shop,375,390,15
208,41,work,390,975,585
209,41,shop,975,990,15
210,41,home,990,1440,450
211,42,home,0,390,390
212,42,shop,390,450,60
213,42,work,450,1035,585
214,42,leisure,1035,1095,60
215,42,home,1095,1440,345
216,43,home,0,375,375
217,43,shop,375,405,30
218,43,work,405,825,420
219,43,education,825,1005,180
220,43,home,1005,1440,435
221,44,home,0,405,405
222,44,shop,405,465,60
223,44,work,465,930,465
224,44,leisure,930,1020,90
225,44,home,1020,1440,420
226,45,home,0,405,405
227,45,work,405,915,510
228,45,shop,915,960,45
229,45,home,960,1440,480
230,46,home,0,390,390
231,46,shop,390,450,60
232,46,work,450,1005,555
233,46,education,1005,1080,75
234,46,home,1080,1440,360
235,47,home,0,375,375
236,47,work,375,810,435
237,47,education,810,975,165
238,47,home,975,1440,465
239,48,home,0,375,375
240,48,shop,375,390,15
241,48,work,390,930,540
242,48,leisure,930,1005,75
243,48,home,1005,1440,435
244,49,home,0,405,405
245,49,work,405,1005,600
246,49,leisure,1005,1065,60
247,49,home,1065,1440,375
248,50,home,0,375,375
249,50,work,375,795,420
250,50,shop,795,900,105
251,50,home,900,1005,105
252,50,education,1005,1065,60
253,50,home,1065,1440,375
254,51,home,0,375,375
255,51,work,375,795,420
256,51,education,795,960,165
257,51,shop,960,975,15
258,51,home,975,1440,465
259,52,home,0,390,390
260,52,shop,390,420,30
261,52,leisure,420,450,30
262,52,work,450,915,465
263,52,shop,915,960,45
264,52,home,960,1440,480
265,53,home,0,405,405
266,53,shop,405,420,15
267,53,work,420,930,510
268,53,shop,930,960,30
269,53,home,960,1440,480
270,54,home,0,405,405
271,54,work,405,960,555
272,54,leisure,960,1065,105
273,54,home,1065,1440,375
274,55,home,0,390,390
275,55,shop,390,405,15
276,55,work,405,945,540
277,55,home,945,1440,495
278,56,home,0,375,375
279,56,shop,375,435,60
280,56,work,435,885,450
281,56,home,885,1440,555
282,57,home,0,375,375
283,57,work,375,795,420
284,57,education,795,975,180
285,57,shop,975,990,15
286,57,home,990,1440,450
287,58,home,0,390,390
288,58,work,390,810,420
289,58,shop,810,960,150
290,58,home,960,1035,75
291,58,leisure,1035,1050,15
292,58,home,1050,1440,390
293,59,home,0,405,405
294,59,work,405,810,405
295,59,education,810,930,120
296,59,leisure,930,990,60
297,59,home,990,1110,120
298,59,shop,1110,1125,15
299,59,home,1125,1440,315
300,60,home,0,390,390
301,60,work,390,825,435
302,60,education,825,975,150
303,60,shop,975,990,15
304,60,home,990,1440,450
305,61,home,0,375,375
306,61,work,375,795,420
307,61,education,795,990,195
308,61,leisure,990,1050,60
309,61,home,1050,1440,390
310,62,home,0,390,390
311,62,shop,390,450,60
312,62,work,450,975,525
313,62,leisure,975,1065,90
314,62,home,1065,1440,375
315,63,home,0,390,390
316,63,shop,390,450,60
317,63,work,450,915,465
318,63,shop,915,960,45
319,63,home,960,1215,255
320,63,leisure,1215,1275,60
321,63,home,1275,1440,165
322,64,home,0,375,375
323,64,work,375,810,435
324,64,education,810,975,165
325,64,home,975,1155,180
326,64,shop,1155,1170,15
327,64,home,1170,1440,270
328,65,home,0,390,390
329,65,work,390,990,600
330,65,leisure,990,1065,75
331,65,home,1065,1440,375
332,66,home,0,375,375
333,66,leisure,375,390,15
334,66,work,390,930,540
335,66,shop,930,960,30
336,66,home,960,1440,480
337,67,home,0,390,390
338,67,leisure,390,405,15
339,67,work,405,975,570
340,67,shop,975,990,15
341,67,home,990,1440,450
342,68,home,0,375,375
343,68,shop,375,405,30
344,68,education,405,510,105
345,68,work,510,1020,510
346,68,education,1020,1080,60
347,68,home,1080,1440,360
348,69,home,0,390,390
349,69,work,390,930,540
350,69,leisure,930,990,60
351,69,home,990,1440,450
352,70,home,0,375,375
353,70,work,375,795,420
354,70,education,795,1035,240
355,70,home,1035,1440,405
356,71,home,0,375,375
357,71,work,375,795,420
358,71,shop,795,870,75
359,71,home,870,1440,570
360,72,home,0,375,375
361,72,shop,375,390,15
362,72,work,390,960,570
363,72,shop,960,975,15
364,72,home,975,1215,240
365,72,leisure,1215,1230,15
366,72,home,1230,1440,210
367,73,home,0,420,420
368,73,shop,420,450,30
369,73,work,450,885,435
370,73,home,885,1080,195
371,73,shop,1080,1095,15
372,73,home,1095,1440,345
373,74,home,0,390,390
374,74,work,390,960,570
375,74,leisure,960,1020,60
376,74,home,1020,1440,420
377,75,home,0,405,405
378,75,work,405,885,480
379,75,shop,885,960,75
380,75,home,960,1440,480
381,76,home,0,390,390
382,76,shop,390,450,60
383,76,work,450,975,525
384,76,leisure,975,1065,90
385,76,home,1065,1440,375
386,77,home,0,375,375
387,77,leisure,375,390,15
388,77,work,390,960,570
389,77,leisure,960,1035,75
390,77,home,1035,1440,405
391,78,home,0,405,405
392,78,leisure,405,420,15
393,78,work,420,990,570
394,78,shop,990,1005,15
395,78,home,1005,1440,435
396,79,home,0,390,390
397,79,shop,390,420,30
398,79,work,420,975,555
399,79,education,975,1065,90
400,79,home,1065,1260,195
401,79,leisure,1260,1335,75
402,79,home,1335,1440,105
403,80,home,0,375,375
404,80,shop,375,390,15
405,80,education,390,495,105
406,80,work,495,930,435
407,80,home,930,1155,225
408,80,leisure,1155,1215,60
409,80,home,1215,1440,225
410,81,home,0,405,405
411,81,shop,405,465,60
412,81,work,465,1005,540
413,81,education,1005,1080,75
414,81,home,1080,1440,360
415,82,home,0,390,390
416,82,leisure,390,405,15
417,82,work,405,975,570
418,82,shop,975,990,15
419,82,home,990,1185,195
420,82,shop,1185,1200,15
421,82,home,1200,1440,240
422,83,home,0,375,375
423,83,work,375,795,420
424,83,education,795,930,135
425,83,shop,930,960,30
426,83,home,960,1095,135
427,83,leisure,1095,1140,45
428,83,home,1140,1440,300
429,84,home,0,375,375
430,84,shop,375,405,30
431,84,work,405,1020,615
432,84,education,1020,1080,60
433,84,home,1080,1440,360
434,85,home,0,390,390
435,85,work,390,810,420
436,85,shop,810,945,135
437,85,home,945,1140,195
438,85,leisure,1140,1200,60
439,85,home,1200,1440,240
440,86,home,0,390,390
441,86,work,390,1005,615
442,86,leisure,1005,1080,75
443,86,home,1080,1440,360
444,87,home,0,405,405
445,87,shop,405,420,15
446,87,work,420,960,540
447,87,shop,960,975,15
448,87,home,975,1155,180
449,87,shop,1155,1170,15
450,87,home,1170,1440,270
451,88,home,0,390,390
452,88,work,390,810,420
453,88,education,810,1005,195
454,88,home,1005,1215,210
455,88,leisure,1215,1275,60
456,88,home,1275,1440,165
457,89,home,0,390,390
458,89,leisure,390,435,45
459,89,work,435,990,555
460,89,education,990,1080,90
461,89,home,1080,1440,360
462,90,home,0,375,375
463,90,work,375,915,540
464,90,leisure,915,990,75
465,90,home,990,1440,450
466,91,home,0,375,375
467,91,work,375,915,540
468,91,shop,915,960,45
469,91,home,960,1440,480
470,92,home,0,390,390
471,92,work,390,945,555
472,92,leisure,945,1020,75
473,92,home,1020,1440,420
474,93,home,0,375,375
475,93,work,375,810,435
476,93,education,810,930,120
477,93,shop,930,960,30
478,93,home,960,1440,480
479,94,home,0,390,390
480,94,shop,390,450,60
481,94,work,450,975,525
482,94,education,975,1080,105
483,94,home,1080,1440,360
484,95,home,0,390,390
485,95,shop,390,435,45
486,95,work,435,930,495
487,95,leisure,930,1005,75
488,95,home,1005,1440,435
489,96,home,0,375,375
490,96,work,375,1005,630
491,96,education,1005,1080,75
492,96,home,1080,1440,360
493,97,home,0,405,405
494,97,leisure,405,465,60
495,97,work,465,975,510
496,97,shop,975,990,15
497,97,home,990,1155,165
498,97,shop,1155,1170,15
499,97,home,1170,1440,270
500,98,home,0,390,390
501,98,work,390,945,555
502,98,leisure,945,1005,60
503,98,home,1005,1440,435
504,99,home,0,375,375
505,99,work,375,795,420
506,99,education,795,975,180
507,99,shop,975,990,15
508,99,home,990,1200,210
509,99,leisure,1200,1260,60
510,99,home,1260,1440,180
511,100,home,0,375,375
512,100,shop,375,420,45
513,100,work,420,1005,585
514,100,education,1005,1080,75
515,100,home,1080,1440,360
516,101,home,0,390,390
517,101,work,390,1020,630
518,101,leisure,1020,1080,60
519,101,home,1080,1440,360
520,102,home,0,420,420
521,102,shop,420,480,60
522,102,education,480,525,45
523,102,work,525,1035,510
524,102,leisure,1035,1065,30
525,102,home,1065,1440,375
526,103,home,0,405,405
527,103,leisure,405,465,60
528,103,work,465,945,480
529,103,leisure,945,1005,60
530,103,home,1005,1440,435
531,104,home,0,390,390
532,104,leisure,390,405,15
533,104,work,405,975,570
534,104,education,975,1080,105
535,104,home,1080,1440,360
536,105,home,0,375,375
537,105,shop,375,390,15
538,105,education,390,480,90
539,105,work,480,1005,525
540,105,leisure,1005,1065,60
541,105,home,1065,1440,375
542,106,home,0,390,390
543,106,shop,390,420,30
544,106,work,420,915,495
545,106,leisure,915,1005,90
546,106,home,1005,1440,435
547,107,home,0,375,375
548,107,work,375,795,420
549,107,education,795,1050,255
550,107,home,1050,1440,390
551,108,home,0,405,405
552,108,work,405,825,420
553,108,education,825,975,150
554,108,home,975,1440,465
555,109,home,0,435,435
556,109,leisure,435,495,60
557,109,work,495,975,480
558,109,education,975,1050,75
559,109,home,1050,1440,390
560,110,home,0,375,375
561,110,leisure,375,420,45
562,110,work,420,915,495
563,110,shop,915,960,45
564,110,home,960,1140,180
565,110,education,1140,1155,15
566,110,home,1155,1440,285
567,111,home,0,375,375
568,111,work,375,960,585
569,111,leisure,960,1035,75
570,111,home,1035,1440,405
571,112,home,0,405,405
572,112,work,405,990,585
573,112,leisure,990,1065,75
574,112,home,1065,1440,375
575,113,home,0,375,375
576,113,work,375,795,420
577,113,education,795,1005,210
578,113,home,1005,1440,435
579,114,home,0,390,390
580,114,shop,390,450,60
581,114,work,450,990,540
582,114,education,990,1080,90
583,114,home,1080,1440,360
584,115,home,0,375,375
585,115,shop,375,390,15
586,115,education,390,510,120
587,115,work,510,1005,495
588,115,shop,1005,1020,15
589,115,home,1020,1440,420
590,116,home,0,375,375
591,116,work,375,765,390
592,116,education,765,960,195
593,116,shop,960,975,15
594,116,home,975,1440,465
595,117,home,0,405,405
596,117,work,405,945,540
597,117,leisure,945,1005,60
598,117,home,1005,1440,435
599,118,home,0,390,390
600,118,shop,390,405,15
601,118,work,405,825,420
602,118,education,825,1035,210
603,118,home,1035,1440,405
604,119,home,0,375,375
605,119,shop,375,435,60
606,119,work,435,915,480
607,119,leisure,915,990,75
608,119,home,990,1440,450
609,120,home,0,390,390
610,120,work,390,810,420
611,120,education,810,930,120
612,120,shop,930,960,30
613,120,home,960,1440,480
614,121,home,0,420,420
615,121,shop,420,435,15
616,121,leisure,435,465,30
617,121,work,465,960,495
618,121,leisure,960,1020,60
619,121,home,1020,1440,420
620,122,home,0,390,390
621,122,work,390,1005,615
622,122,education,1005,1080,75
623,122,shop,1080,1095,15
624,122,home,1095,1440,345
625,123,home,0,390,390
626,123,shop,390,450,60
627,123,work,450,1005,555
628,123,leisure,1005,1065,60
629,123,home,1065,1440,375
630,124,home,0,390,390
631,124,work,390,810,420
632,124,shop,810,870,60
633,124,home,870,1125,255
634,124,shop,1125,1140,15
635,124,home,1140,1440,300
636,125,home,0,390,390
637,125,work,390,930,540
638,125,shop,930,960,30
639,125,home,960,1440,480
640,126,home,0,375,375
641,126,shop,375,405,30
642,126,work,405,930,525
643,126,shop,930,960,30
644,126,home,960,1440,480
645,127,home,0,390,390
646,127,leisure,390,435,45
647,127,work,435,900,465
648,127,shop,900,960,60
649,127,home,960,1440,480
650,128,home,0,390,390
651,128,leisure,390,450,60
652,128,work,450,1020,570
653,128,education,1020,1080,60
654,128,home,1080,1440,360
655,129,home,0,375,375
656,129,work,375,825,450
657,129,education,825,975,150
658,129,home,975,1155,180
659,129,shop,1155,1170,15
660,129,home,1170,1440,270
661,130,home,0,390,390
662,130,work,390,825,435
663,130,shop,825,960,135
664,130,home,960,1440,480
665,131,home,0,390,390
666,131,shop,390,420,30
667,131,work,420,1050,630
668,131,education,1050,1080,30
669,131,home,1080,1440,360
670,132,home,0,390,390
671,132,shop,390,435,45
672,132,work,435,990,555
673,132,shop,990,1005,15
674,132,home,1005,1440,435
675,133,home,0,390,390
676,133,shop,390,405,15
677,133,leisure,405,420,15
678,133,work,420,990,570
679,133,home,990,1440,450
680,134,home,0,390,390
681,134,work,390,990,600
682,134,education,990,1080,90
683,134,home,1080,1440,360
684,135,home,0,375,375
685,135,shop,375,390,15
686,135,work,390,975,585
687,135,education,975,1080,105
688,135,home,1080,1440,360
689,136,home,0,375,375
690,136,shop,375,420,45
691,136,leisure,420,435,15
692,136,work,435,1005,570
693,136,shop,1005,1020,15
694,136,home,1020,1440,420
695,137,home,0,390,390
696,137,work,390,930,540
697,137,leisure,930,990,60
698,137,shop,990,1005,15
699,137,home,1005,1440,435
700,138,home,0,375,375
701,138,leisure,375,435,60
702,138,work,435,990,555
703,138,education,990,1080,90
704,138,home,1080,1440,360
705,139,home,0,390,390
706,139,shop,390,405,15
707,139,work,405,960,555
708,139,leisure,960,1020,60
709,139,home,1020,1440,420
710,140,home,0,390,390
711,140,leisure,390,405,15
712,140,work,405,945,540
713,140,shop,945,960,15
714,140,home,960,1440,480
715,141,home,0,420,420
716,141,work,420,915,495
717,141,shop,915,960,45
718,141,home,960,1050,90
719,141,shop,1050,1065,15
720,141,home,1065,1440,375
721,142,home,0,375,375
722,142,leisure,375,390,15
723,142,work,390,825,435
724,142,education,825,1005,180
725,142,home,1005,1440,435
726,143,home,0,375,375
727,143,work,375,810,435
728,143,education,810,975,165
729,143,home,975,1440,465
730,144,home,0,375,375
731,144,shop,375,435,60
732,144,work,435,930,495
733,144,leisure,930,990,60
734,144,home,990,1440,450
735,145,home,0,390,390
736,145,work,390,990,600
737,145,home,990,1440,450
738,146,home,0,375,375
739,146,work,375,915,540
740,146,leisure,915,960,45
741,146,shop,960,975,15
742,146,home,975,1185,210
743,146,leisure,1185,1230,45
744,146,home,1230,1440,210
745,147,home,0,375,375
746,147,work,375,795,420
747,147,education,795,915,120
748,147,shop,915,960,45
749,147,home,960,1140,180
750,147,leisure,1140,1215,75
751,147,home,1215,1440,225
752,148,home,0,375,375
753,148,shop,375,435,60
754,148,work,435,1050,615
755,148,education,1050,1080,30
756,148,home,1080,1440,360
757,149,home,0,405,405
758,149,work,405,915,510
759,149,shop,915,960,45
760,149,home,960,1440,480
761,150,home,0,375,375
762,150,shop,375,435,60
763,150,leisure,435,495,60
764,150,work,495,975,480
765,150,education,975,1080,105
766,150,home,1080,1440,360
767,151,home,0,390,390
768,151,leisure,390,420,30
769,151,work,420,975,555
770,151,education,975,1080,105
771,151,home,1080,1440,360
772,152,home,0,375,375
773,152,work,375,810,435
774,152,education,810,1035,225
775,152,home,1035,1440,405
776,153,home,0,375,375
777,153,work,375,810,435
778,153,education,810,960,150
779,153,leisure,960,1020,60
780,153,home,1020,1440,420
781,154,home,0,390,390
782,154,shop,390,420,30
783,154,work,420,960,540
784,154,leisure,960,1035,75
785,154,home,1035,1440,405
786,155,home,0,420,420
787,155,work,420,975,555
788,155,leisure,975,1035,60
789,155,home,1035,1440,405
790,156,home,0,375,375
791,156,leisure,375,420,45
792,156,work,420,900,480
793,156,shop,900,960,60
794,156,home,960,1440,480
795,157,home,0,375,375
796,157,work,375,810,435
797,157,education,810,1035,225
798,157,home,1035,1230,195
799,157,leisure,1230,1275,45
800,157,home,1275,1440,165
801,158,home,0,375,375
802,158,shop,375,435,60
803,158,work,435,930,495
804,158,leisure,930,1050,120
805,158,home,1050,1440,390
806,159,home,0,390,390
807,159,work,390,810,420
808,159,education,810,945,135
809,159,shop,945,960,15
810,159,home,960,1170,210
811,159,leisure,1170,1230,60
812,159,home,1230,1440,210
813,160,home,0,390,390
814,160,work,390,990,600
815,160,education,990,1080,90
816,160,home,1080,1440,360
817,161,home,0,375,375
818,161,leisure,375,420,45
819,161,work,420,1005,585
820,161,shop,1005,1020,15
821,161,home,1020,1440,420
822,162,home,0,375,375
823,162,shop,375,390,15
824,162,work,390,825,435
825,162,education,825,990,165
826,162,home,990,1440,450
827,163,home,0,375,375
828,163,shop,375,390,15
829,163,work,390,810,420
830,163,education,810,945,135
831,163,leisure,945,1020,75
832,163,home,1020,1440,420
833,164,home,0,420,420
834,164,work,420,885,465
835,164,shop,885,960,75
836,164,home,960,1440,480
837,165,home,0,375,375
838,165,work,375,795,420
839,165,education,795,930,135
840,165,shop,930,960,30
841,165,home,960,1440,480
842,166,home,0,390,390
843,166,work,390,810,420
844,166,education,810,1005,195
845,166,shop,1005,1020,15
846,166,home,1020,1440,420
847,167,home,0,390,390
848,167,work,390,825,435
849,167,education,825,975,150
850,167,home,975,1440,465
851,168,home,0,390,390
852,168,shop,390,420,30
853,168,work,420,1050,630
854,168,education,1050,1080,30
855,168,home,1080,1440,360
856,169,home,0,390,390
857,169,shop,390,450,60
858,169,education,450,585,135
859,169,work,585,1050,465
860,169,home,1050,1440,390
861,170,home,0,405,405
862,170,shop,405,435,30
863,170,leisure,435,450,15
864,170,work,450,930,480
865,170,shop,930,960,30
866,170,home,960,1440,480
867,171,home,0,405,405
868,171,shop,405,450,45
869,171,work,450,945,495
870,171,leisure,945,1020,75
871,171,home,1020,1440,420
872,172,home,0,405,405
873,172,shop,405,465,60
874,172,work,465,1005,540
875,172,education,1005,1080,75
876,172,home,1080,1440,360
877,173,home,0,390,390
878,173,leisure,390,450,60
879,173,work,450,975,525
880,173,education,975,1080,105
881,173,home,1080,1440,360
882,174,home,0,405,405
883,174,work,405,855,450
884,174,shop,855,930,75
885,174,home,930,1440,510
886,175,home,0,375,375
887,175,shop,375,405,30
888,175,work,405,945,540
889,175,leisure,945,1035,90
890,175,home,1035,1440,405
891,176,home,0,375,375
892,176,shop,375,405,30
893,176,work,405,930,525
894,176,shop,930,960,30
895,176,home,960,1140,180
896,176,education,1140,1155,15
897,176,home,1155,1440,285
898,177,home,0,375,375
899,177,shop,375,420,45
900,177,work,420,945,525
901,177,leisure,945,1035,90
902,177,home,1035,1440,405
903,178,home,0,405,405
904,178,work,405,825,420
905,178,education,825,960,135
906,178,shop,960,975,15
907,178,home,975,1440,465
908,179,home,0,390,390
909,179,shop,390,435,45
910,179,work,435,870,435
911,179,home,870,1080,210
912,179,education,1080,1095,15
913,179,home,1095,1440,345
914,180,home,0,405,405
915,180,work,405,945,540
916,180,leisure,945,1035,90
917,180,home,1035,1440,405
918,181,home,0,375,375
919,181,work,375,795,420
920,181,education,795,915,120
921,181,shop,915,960,45
922,181,home,960,1440,480
923,182,home,0,375,375
924,182,work,375,825,450
925,182,shop,825,945,120
926,182,home,945,1440,495
927,183,home,0,375,375
928,183,shop,375,450,75
929,183,work,450,915,465
930,183,leisure,915,990,75
931,183,home,990,1440,450
932,184,home,0,375,375
933,184,shop,375,390,15
934,184,work,390,825,435
935,184,education,825,1050,225
936,184,home,1050,1440,390
937,185,home,0,390,390
938,185,work,390,810,420
939,185,education,810,975,165
940,185,shop,975,990,15
941,185,home,990,1440,450
942,186,home,0,390,390
943,186,shop,390,420,30
944,186,work,420,945,525
945,186,leisure,945,1050,105
946,186,home,1050,1440,390
947,187,home,0,390,390
948,187,shop,390,405,15
949,187,work,405,1005,600
950,187,shop,1005,1020,15
951,187,home,1020,1440,420
952,188,home,0,375,375
953,188,leisure,375,435,60
954,188,work,435,1020,585
955,188,education,1020,1080,60
956,188,home,1080,1440,360
957,189,home,0,375,375
958,189,work,375,810,435
959,189,shop,810,870,60
960,189,home,870,1080,210
961,189,leisure,1080,1155,75
962,189,home,1155,1440,285
963,190,home,0,405,405
964,190,shop,405,465,60
965,190,work,465,915,450
966,190,leisure,915,975,60
967,190,home,975,1440,465
968,191,home,0,390,390
969,191,work,390,975,585
970,191,education,975,1065,90
971,191,home,1065,1440,375
972,192,home,0,405,405
973,192,shop,405,420,15
974,192,work,420,990,570
975,192,education,990,1080,90
976,192,home,1080,1440,360
977,193,home,0,375,375
978,193,shop,375,390,15
979,193,work,390,915,525
980,193,shop,915,960,45
981,193,home,960,1170,210
982,193,leisure,1170,1245,75
983,193,home,1245,1440,195
984,194,home,0,375,375
985,194,work,375,810,435
986,194,education,810,990,180
987,194,shop,990,1005,15
988,194,home,1005,1440,435
989,195,home,0,405,405
990,195,leisure,405,435,30
991,195,work,435,960,525
992,195,leisure,960,1035,75
993,195,home,1035,1440,405
994,196,home,0,375,375
995,196,work,375,960,585
996,196,leisure,960,1020,60
997,196,home,1020,1440,420
998,197,home,0,390,390
999,197,shop,390,420,30
1000,197,work,420,1005,585
1001,197,education,1005,1080,75
1002,197,home,1080,1440,360
1003,198,home,0,375,375
1004,198,shop,375,405,30
1005,198,education,405,525,120
1006,198,work,525,960,435
1007,198,leisure,960,1020,60
1008,198,home,1020,1440,420
1009,199,home,0,375,375
1010,199,shop,375,390,15
1011,199,work,390,810,420
1012,199,education,810,930,120
1013,199,shop,930,960,30
1014,199,home,960,1440,480
1015,200,home,0,405,405
1016,200,work,405,960,555
1017,200,leisure,960,1080,120
1018,200,home,1080,1440,360
1019,201,home,0,375,375
1020,201,work,375,915,540
1021,201,leisure,915,990,75
1022,201,home,990,1440,450
1023,202,home,0,390,390
1024,202,work,390,990,600
1025,202,shop,990,1005,15
1026,202,home,1005,1440,435
1027,203,home,0,390,390
1028,203,work,390,975,585
1029,203,education,975,1080,105
1030,203,home,1080,1440,360
1031,204,home,0,390,390
1032,204,shop,390,435,45
1033,204,work,435,930,495
1034,204,leisure,930,1005,75
1035,204,home,1005,1440,435
1036,205,home,0,375,375
1037,205,work,375,780,405
1038,205,education,780,930,150
1039,205,shop,930,960,30
1040,205,home,960,1440,480
1041,206,home,0,390,390
1042,206,shop,390,450,60
1043,206,work,450,1050,600
1044,206,education,1050,1080,30
1045,206,home,1080,1440,360
1046,207,home,0,375,375
1047,207,shop,375,420,45
1048,207,work,420,1005,585
1049,207,education,1005,1080,75
1050,207,home,1080,1440,360
1051,208,home,0,405,405
1052,208,work,405,915,510
1053,208,leisure,915,990,75
1054,208,home,990,1440,450
1055,209,home,0,390,390
1056,209,shop,390,450,60
1057,209,work,450,975,525
1058,209,leisure,975,1080,105
1059,209,home,1080,1440,360
1060,210,home,0,375,375
1061,210,shop,375,435,60
1062,210,work,435,1005,570
1063,210,education,1005,1080,75
1064,210,home,1080,1440,360
1065,211,home,0,375,375
1066,211,work,375,795,420
1067,211,education,795,915,120
1068,211,leisure,915,1020,105
1069,211,home,1020,1440,420
1070,212,home,0,375,375
1071,212,shop,375,420,45
1072,212,education,420,540,120
1073,212,work,540,990,450
1074,212,leisure,990,1080,90
1075,212,home,1080,1440,360
1076,213,home,0,390,390
1077,213,work,390,885,495
1078,213,shop,885,960,75
1079,213,home,960,1440,480
1080,214,home,0,390,390
1081,214,work,390,885,495
1082,214,home,885,1095,210
1083,214,shop,1095,1110,15
1084,214,home,1110,1440,330
1085,215,home,0,405,405
1086,215,shop,405,435,30
1087,215,work,435,945,510
1088,215,leisure,945,1005,60
1089,215,home,1005,1440,435
1090,216,home,0,390,390
1091,216,work,390,810,420
1092,216,education,810,990,180
1093,216,home,990,1440,450
1094,217,home,0,390,390
1095,217,leisure,390,450,60
1096,217,work,450,1050,600
1097,217,home,1050,1440,390
1098,218,home,0,390,390
1099,218,shop,390,450,60
1100,218,education,450,570,120
1101,218,work,570,1020,450
1102,218,leisure,1020,1095,75
1103,218,home,1095,1440,345
1104,219,home,0,390,390
1105,219,work,390,975,585
1106,219,leisure,975,1050,75
1107,219,home,1050,1440,390
1108,220,home,0,405,405
1109,220,work,405,930,525
1110,220,leisure,930,1020,90
1111,220,home,1020,1440,420
1112,221,home,0,405,405
1113,221,shop,405,420,15
1114,221,work,420,975,555
1115,221,leisure,975,1050,75
1116,221,home,1050,1440,390
1117,222,home,0,375,375
1118,222,leisure,375,420,45
1119,222,work,420,990,570
1120,222,education,990,1080,90
1121,222,home,1080,1440,360
1122,223,home,0,390,390
1123,223,work,390,1005,615
1124,223,leisure,1005,1065,60
1125,223,home,1065,1440,375
1126,224,home,0,390,390
1127,224,leisure,390,450,60
1128,224,work,450,1020,570
1129,224,education,1020,1080,60
1130,224,home,1080,1440,360
1131,225,home,0,420,420
1132,225,shop,420,465,45
1133,225,work,465,1005,540
1134,225,education,1005,1080,75
1135,225,home,1080,1440,360
1136,226,home,0,390,390
1137,226,leisure,390,435,45
1138,226,work,435,1020,585
1139,226,education,1020,1080,60
1140,226,home,1080,1440,360
1141,227,home,0,390,390
1142,227,shop,390,435,45
1143,227,home,435,510,75
1144,227,education,510,615,105
1145,227,work,615,1035,420
1146,227,home,1035,1215,180
1147,227,leisure,1215,1260,45
1148,227,home,1260,1440,180
1149,228,home,0,375,375
1150,228,work,375,795,420
1151,228,education,795,1005,210
1152,228,home,1005,1440,435
1153,229,home,0,405,405
1154,229,work,405,990,585
1155,229,leisure,990,1095,105
1156,229,home,1095,1440,345
1157,230,home,0,390,390
1158,230,work,390,810,420
1159,230,education,810,990,180
1160,230,home,990,1440,450
1161,231,home,0,390,390
1162,231,work,390,900,510
1163,231,home,900,1080,180
1164,231,leisure,1080,1140,60
1165,231,home,1140,1440,300
1166,232,home,0,375,375
1167,232,shop,375,420,45
1168,232,work,420,1020,600
1169,232,education,1020,1080,60
1170,232,home,1080,1440,360
1171,233,home,0,375,375
1172,233,work,375,990,615
1173,233,shop,990,1005,15
1174,233,home,1005,1185,180
1175,233,shop,1185,1200,15
1176,233,home,1200,1440,240
1177,234,home,0,375,375
1178,234,leisure,375,420,45
1179,234,work,420,975,555
1180,234,education,975,1065,90
1181,234,home,1065,1440,375
1182,235,home,0,390,390
1183,235,shop,390,420,30
1184,235,education,420,495,75
1185,235,work,495,975,480
1186,235,leisure,975,1035,60
1187,235,home,1035,1440,405
1188,236,home,0,405,405
1189,236,shop,405,420,15
1190,236,work,420,1005,585
1191,236,education,1005,1080,75
1192,236,home,1080,1440,360
1193,237,home,0,390,390
1194,237,shop,390,405,15
1195,237,work,405,960,555
1196,237,leisure,960,1020,60
1197,237,home,1020,1440,420
1198,238,home,0,375,375
1199,238,shop,375,435,60
1200,238,work,435,990,555
1201,238,education,990,1080,90
1202,238,home,1080,1440,360
1203,239,home,0,405,405
1204,239,work,405,870,465
1205,239,shop,870,945,75
1206,239,home,945,1440,495
1207,240,home,0,375,375
1208,240,leisure,375,405,30
1209,240,work,405,900,495
1210,240,shop,900,960,60
1211,240,home,960,1440,480
1212,241,home,0,390,390
1213,241,work,390,810,420
1214,241,education,810,975,165
1215,241,home,975,1440,465
1216,242,home,0,375,375
1217,242,shop,375,450,75
1218,242,work,450,930,480
1219,242,leisure,930,990,60
1220,242,home,990,1440,450
1221,243,home,0,405,405
1222,243,shop,405,420,15
1223,243,work,420,990,570
1224,243,education,990,1080,90
1225,243,home,1080,1440,360
1226,244,home,0,375,375
1227,244,leisure,375,435,60
1228,244,work,435,990,555
1229,244,education,990,1080,90
1230,244,home,1080,1440,360
1231,245,home,0,390,390
1232,245,work,390,945,555
1233,245,leisure,945,1020,75
1234,245,home,1020,1440,420
1235,246,home,0,375,375
1236,246,work,375,780,405
1237,246,education,780,885,105
1238,246,leisure,885,990,105
1239,246,home,990,1440,450
1240,247,home,0,390,390
1241,247,shop,390,420,30
1242,247,work,420,975,555
1243,247,education,975,1080,105
1244,247,home,1080,1440,360
1245,248,home,0,390,390
1246,248,work,390,825,435
1247,248,shop,825,945,120
1248,248,home,945,1140,195
1249,248,leisure,1140,1200,60
1250,248,home,1200,1440,240
1251,249,home,0,435,435
1252,249,work,435,945,510
1253,249,shop,945,960,15
1254,249,home,960,1440,480
1255,250,home,0,390,390
1256,250,work,390,915,525
1257,250,shop,915,960,45
1258,250,home,960,1140,180
1259,250,education,1140,1155,15
1260,250,home,1155,1440,285
1261,251,home,0,390,390
1262,251,work,390,825,435
1263,251,education,825,990,165
1264,251,home,990,1440,450
1265,252,home,0,390,390
1266,252,work,390,990,600
1267,252,education,990,1080,90
1268,252,home,1080,1140,60
1269,252,shop,1140,1155,15
1270,252,home,1155,1440,285
1271,253,home,0,375,375
1272,253,leisure,375,435,60
1273,253,work,435,1050,615
1274,253,education,1050,1080,30
1275,253,home,1080,1440,360
1276,254,home,0,390,390
1277,254,leisure,390,405,15
1278,254,work,405,855,450
1279,254,shop,855,945,90
1280,254,home,945,1440,495
1281,255,home,0,390,390
1282,255,work,390,990,600
1283,255,education,990,1080,90
1284,255,home,1080,1440,360
1285,256,home,0,390,390
1286,256,shop,390,435,45
1287,256,work,435,960,525
1288,256,leisure,960,1020,60
1289,256,home,1020,1440,420
1290,257,home,0,390,390
1291,257,shop,390,435,45
1292,257,work,435,960,525
1293,257,leisure,960,1020,60
1294,257,home,1020,1440,420
1295,258,home,0,405,405
1296,258,leisure,405,420,15
1297,258,work,420,975,555
1298,258,leisure,975,1065,90
1299,258,home,1065,1440,375
1300,259,home,0,390,390
1301,259,work,390,780,390
1302,259,education,780,990,210
1303,259,home,990,1230,240
1304,259,leisure,1230,1290,60
1305,259,home,1290,1440,150
1306,260,home,0,375,375
1307,260,shop,375,420,45
1308,260,education,420,540,120
1309,260,work,540,1020,480
1310,260,leisure,1020,1065,45
1311,260,home,1065,1440,375
1312,261,home,0,375,375
1313,261,work,375,975,600
1314,261,shop,975,990,15
1315,261,home,990,1440,450
1316,262,home,0,375,375
1317,262,work,375,885,510
1318,262,home,885,1005,120
1319,262,shop,1005,1020,15
1320,262,home,1020,1440,420
1321,263,home,0,420,420
1322,263,shop,420,435,15
1323,263,work,435,915,480
1324,263,leisure,915,975,60
1325,263,home,975,1440,465
1326,264,home,0,390,390
1327,264,work,390,810,420
1328,264,education,810,990,180
1329,264,shop,990,1005,15
1330,264,home,1005,1185,180
1331,264,shop,1185,1200,15
1332,264,home,1200,1440,240
1333,265,home,0,390,390
1334,265,shop,390,405,15
1335,265,work,405,975,570
1336,265,education,975,1080,105
1337,265,home,1080,1440,360
1338,266,home,0,375,375
1339,266,leisure,375,420,45
1340,266,work,420,915,495
1341,266,shop,915,960,45
1342,266,home,960,1440,480
1343,267,home,0,375,375
1344,267,shop,375,390,15
1345,267,work,390,810,420
1346,267,education,810,1020,210
1347,267,home,1020,1440,420
1348,268,home,0,390,390
1349,268,work,390,930,540
1350,268,home,930,1185,255
1351,268,shop,1185,1200,15
1352,268,home,1200,1440,240
1353,269,home,0,390,390
1354,269,work,390,960,570
1355,269,shop,960,975,15
1356,269,home,975,1140,165
1357,269,shop,1140,1155,15
1358,269,home,1155,1440,285
1359,270,home,0,390,390
1360,270,work,390,810,420
1361,270,education,810,930,120
1362,270,leisure,930,990,60
1363,270,shop,990,1005,15
1364,270,home,1005,1440,435
1365,271,home,0,375,375
1366,271,shop,375,405,30
1367,271,work,405,1020,615
1368,271,education,1020,1080,60
1369,271,home,1080,1440,360
1370,272,home,0,375,375
1371,272,work,375,990,615
1372,272,education,990,1080,90
1373,272,home,1080,1440,360
1374,273,home,0,390,390
1375,273,leisure,390,435,45
1376,273,work,435,885,450
1377,273,shop,885,960,75
1378,273,home,960,1440,480
1379,274,home,0,375,375
1380,274,shop,375,390,15
1381,274,education,390,480,90
1382,274,work,480,990,510
1383,274,leisure,990,1065,75
1384,274,home,1065,1440,375
1385,275,home,0,390,390
1386,275,leisure,390,405,15
1387,275,work,405,930,525
1388,275,shop,930,960,30
1389,275,home,960,1140,180
1390,275,leisure,1140,1230,90
1391,275,home,1230,1440,210
1392,276,home,0,375,375
1393,276,shop,375,405,30
1394,276,work,405,915,510
1395,276,shop,915,960,45
1396,276,home,960,1125,165
1397,276,leisure,1125,1185,60
1398,276,home,1185,1440,255
1399,277,home,0,375,375
1400,277,shop,375,390,15
1401,277,work,390,975,585
1402,277,leisure,975,1035,60
1403,277,home,1035,1440,405
1404,278,home,0,375,375
1405,278,leisure,375,450,75
1406,278,work,450,975,525
1407,278,education,975,1080,105
1408,278,home,1080,1440,360
1409,279,home,0,390,390
1410,279,work,390,975,585
1411,279,education,975,1080,105
1412,279,home,1080,1440,360
1413,280,home,0,375,375
1414,280,leisure,375,435,60
1415,280,work,435,1005,570
1416,280,education,1005,1080,75
1417,280,home,1080,1440,360
1418,281,home,0,390,390
1419,281,work,390,795,405
1420,281,education,795,1020,225
1421,281,home,1020,1440,420
1422,282,home,0,420,420
1423,282,work,420,990,570
1424,282,education,990,1080,90
1425,282,home,1080,1440,360
1426,283,home,0,390,390
1427,283,shop,390,450,60
1428,283,work,450,915,465
1429,283,leisure,915,1005,90
1430,283,home,1005,1440,435
1431,284,home,0,405,405
1432,284,work,405,1005,600
1433,284,leisure,1005,1050,45
1434,284,home,1050,1440,390
1435,285,home,0,390,390
1436,285,shop,390,405,15
1437,285,work,405,825,420
1438,285,education,825,960,135
1439,285,leisure,960,1020,60
1440,285,home,1020,1440,420
1441,286,home,0,390,390
1442,286,work,390,870,480
1443,286,shop,870,945,75
1444,286,home,945,1440,495
1445,287,home,0,390,390
1446,287,shop,390,450,60
1447,287,work,450,1005,555
1448,287,education,1005,1080,75
1449,287,home,1080,1440,360
1450,288,home,0,390,390
1451,288,work,390,990,600
1452,288,shop,990,1005,15
1453,288,home,1005,1440,435
1454,289,home,0,390,390
1455,289,leisure,390,450,60
1456,289,work,450,990,540
1457,289,education,990,1080,90
1458,289,home,1080,1440,360
1459,290,home,0,375,375
1460,290,leisure,375,390,15
1461,290,work,390,810,420
1462,290,education,810,975,165
1463,290,home,975,1440,465
1464,291,home,0,390,390
1465,291,shop,390,420,30
1466,291,work,420,975,555
1467,291,shop,975,990,15
1468,291,home,990,1440,450
1469,292,home,0,405,405
1470,292,leisure,405,450,45
1471,292,work,450,975,525
1472,292,education,975,1080,105
1473,292,home,1080,1440,360
1474,293,home,0,390,390
1475,293,leisure,390,435,45
1476,293,work,435,1020,585
1477,293,shop,1020,1035,15
1478,293,home,1035,1440,405
1479,294,home,0,375,375
1480,294,work,375,945,570
1481,294,leisure,945,1020,75
1482,294,home,1020,1440,420
1483,295,home,0,390,390
1484,295,shop,390,405,15
1485,295,work,405,960,555
1486,295,leisure,960,1020,60
1487,295,home,1020,1440,420
1488,296,home,0,405,405
1489,296,shop,405,450,45
1490,296,work,450,945,495
1491,296,leisure,945,1035,90
1492,296,home,1035,1440,405
1493,297,home,0,375,375
1494,297,shop,375,390,15
1495,297,work,390,960,570
1496,297,leisure,960,1035,75
1497,297,home,1035,1440,405
1498,298,home,0,375,375
1499,298,work,375,960,585
1500,298,leisure,960,1020,60
1501,298,home,1020,1440,420
1502,299,home,0,435,435
1503,299,shop,435,465,30
1504,299,education,465,570,105
1505,299,work,570,1035,465
1506,299,leisure,1035,1095,60
1507,299,shop,1095,1110,15
1508,299,home,1110,1440,330
1509,300,home,0,405,405
1510,300,shop,405,450,45
1511,300,work,450,975,525
1512,300,education,975,1050,75
1513,300,home,1050,1440,390
1514,301,home,0,405,405
1515,301,shop,405,450,45
1516,301,education,450,495,45
1517,301,work,495,930,435
1518,301,leisure,930,990,60
1519,301,home,990,1440,450
1520,302,home,0,390,390
1521,302,shop,390,405,15
1522,302,work,405,825,420
1523,302,education,825,990,165
1524,302,home,990,1440,450
1525,303,home,0,390,390
1526,303,leisure,390,450,60
1527,303,work,450,915,465
1528,303,shop,915,960,45
1529,303,home,960,1440,480
1530,304,home,0,390,390
1531,304,work,390,1035,645
1532,304,home,1035,1260,225
1533,304,leisure,1260,1275,15
1534,304,home,1275,1440,165
1535,305,home,0,375,375
1536,305,work,375,960,585
1537,305,leisure,960,1020,60
1538,305,home,1020,1440,420
1539,306,home,0,375,375
1540,306,shop,375,405,30
1541,306,work,405,975,570
1542,306,education,975,1080,105
1543,306,home,1080,1440,360
1544,307,home,0,375,375
1545,307,shop,375,390,15
1546,307,work,390,780,390
1547,307,education,780,975,195
1548,307,home,975,1215,240
1549,307,leisure,1215,1275,60
1550,307,home,1275,1440,165
1551,308,home,0,375,375
1552,308,shop,375,405,30
1553,308,work,405,975,570
1554,308,education,975,1080,105
1555,308,home,1080,1440,360
1556,309,home,0,375,375
1557,309,shop,375,390,15
1558,309,work,390,825,435
1559,309,education,825,975,150
1560,309,home,975,1440,465
1561,310,home,0,390,390
1562,310,leisure,390,435,45
1563,310,work,435,1005,570
1564,310,education,1005,1080,75
1565,310,home,1080,1440,360
1566,311,home,0,375,375
1567,311,shop,375,420,45
1568,311,work,420,915,495
1569,311,leisure,915,990,75
1570,311,home,990,1440,450
1571,312,home,0,375,375
1572,312,leisure,375,435,60
1573,312,work,435,930,495
1574,312,shop,930,960,30
1575,312,home,960,1440,480
1576,313,home,0,375,375
1577,313,shop,375,405,30
1578,313,work,405,825,420
1579,313,shop,825,960,135
1580,313,home,960,1440,480
1581,314,home,0,405,405
1582,314,shop,405,435,30
1583,314,work,435,885,450
1584,314,shop,885,960,75
1585,314,home,960,1440,480
1586,315,home,0,375,375
1587,315,shop,375,405,30
1588,315,work,405,885,480
1589,315,shop,885,960,75
1590,315,home,960,1440,480
1591,316,home,0,390,390
1592,316,shop,390,405,15
1593,316,work,405,810,405
1594,316,education,810,1005,195
1595,316,shop,1005,1020,15
1596,316,home,1020,1440,420
1597,317,home,0,375,375
1598,317,work,375,810,435
1599,317,education,810,990,180
1600,317,home,990,1440,450
1601,318,home,0,375,375
1602,318,work,375,810,435
1603,318,shop,810,930,120
1604,318,home,930,1440,510
1605,319,home,0,375,375
1606,319,leisure,375,390,15
1607,319,work,390,990,600
1608,319,education,990,1080,90
1609,319,home,1080,1440,360
1610,320,home,0,405,405
1611,320,shop,405,465,60
1612,320,work,465,975,510
1613,320,education,975,1080,105
1614,320,home,1080,1440,360
1615,321,home,0,420,420
1616,321,shop,420,450,30
1617,321,work,450,960,510
1618,321,leisure,960,1080,120
1619,321,home,1080,1440,360
1620,322,home,0,375,375
1621,322,work,375,810,435
1622,322,education,810,990,180
1623,322,home,990,1440,450
1624,323,home,0,375,375
1625,323,shop,375,390,15
1626,323,work,390,990,600
1627,323,education,990,1080,90
1628,323,home,1080,1440,360
1629,324,home,0,375,375
1630,324,shop,375,405,30
1631,324,work,405,915,510
1632,324,shop,915,960,45
1633,324,home,960,1440,480
1634,325,home,0,405,405
1635,325,leisure,405,435,30
1636,325,work,435,960,525
1637,325,shop,960,975,15
1638,325,home,975,1185,210
1639,325,education,1185,1200,15
1640,325,home,1200,1440,240
1641,326,home,0,375,375
1642,326,shop,375,435,60
1643,326,work,435,930,495
1644,326,leisure,930,990,60
1645,326,home,990,1440,450
1646,327,home,0,375,375
1647,327,work,375,795,420
1648,327,education,795,915,120
1649,327,leisure,915,1020,105
1650,327,home,1020,1440,420
1651,328,home,0,405,405
1652,328,leisure,405,465,60
1653,328,work,465,1020,555
1654,328,education,1020,1080,60
1655,328,home,1080,1440,360
1656,329,home,0,375,375
1657,329,shop,375,435,60
1658,329,work,435,975,540
1659,329,leisure,975,1035,60
1660,329,home,1035,1440,405
1661,330,home,0,375,375
1662,330,shop,375,420,45
1663,330,leisure,420,465,45
1664,330,work,465,1020,555
1665,330,education,1020,1080,60
1666,330,home,1080,1440,360
1667,331,home,0,375,375
1668,331,shop,375,435,60
1669,331,work,435,975,540
1670,331,education,975,1080,105
1671,331,home,1080,1440,360
1672,332,home,0,405,405
1673,332,leisure,405,435,30
1674,332,work,435,990,555
1675,332,shop,990,1005,15
1676,332,home,1005,1440,435
1677,333,home,0,405,405
1678,333,leisure,405,450,45
1679,333,work,450,915,465
1680,333,shop,915,960,45
1681,333,home,960,1440,480
1682,334,home,0,375,375
1683,334,work,375,795,420
1684,334,shop,795,900,105
1685,334,home,900,1440,540
1686,335,home,0,390,390
1687,335,shop,390,420,30
1688,335,work,420,960,540
1689,335,shop,960,975,15
1690,335,home,975,1440,465
1691,336,home,0,390,390
1692,336,work,390,780,390
1693,336,education,780,930,150
1694,336,leisure,930,1005,75
1695,336,home,1005,1440,435
1696,337,home,0,405,405
1697,337,work,405,990,585
1698,337,education,990,1080,90
1699,337,home,1080,1440,360
1700,338,home,0,375,375
1701,338,shop,375,420,45
1702,338,work,420,960,540
1703,338,leisure,960,1110,150
1704,338,home,1110,1440,330
1705,339,home,0,405,405
1706,339,shop,405,420,15
1707,339,work,420,975,555
1708,339,leisure,975,1035,60
1709,339,home,1035,1440,405
1710,340,home,0,375,375
1711,340,work,375,765,390
1712,340,education,765,855,90
1713,340,shop,855,960,105
1714,340,home,960,1170,210
1715,340,leisure,1170,1230,60
1716,340,home,1230,1440,210
1717,341,home,0,390,390
1718,341,work,390,975,585
1719,341,leisure,975,1065,90
1720,341,shop,1065,1080,15
1721,341,home,1080,1440,360
1722,342,home,0,375,375
1723,342,work,375,855,480
1724,342,home,855,1050,195
1725,342,shop,1050,1065,15
1726,342,home,1065,1440,375
1727,343,home,0,390,390
1728,343,work,390,810,420
1729,343,education,810,975,165
1730,343,home,975,1155,180
1731,343,shop,1155,1170,15
1732,343,home,1170,1440,270
1733,344,home,0,390,390
1734,344,leisure,390,435,45
1735,344,work,435,1035,600
1736,344,education,1035,1080,45
1737,344,home,1080,1440,360
1738,345,home,0,390,390
1739,345,shop,390,435,45
1740,345,work,435,1005,570
1741,345,education,1005,1080,75
1742,345,home,1080,1440,360
1743,346,home,0,390,390
1744,346,shop,390,435,45
1745,346,work,435,960,525
1746,346,leisure,960,1020,60
1747,346,home,1020,1440,420
1748,347,home,0,390,390
1749,347,work,390,990,600
1750,347,education,990,1080,90
1751,347,home,1080,1440,360
1752,348,home,0,375,375
1753,348,work,375,975,600
1754,348,leisure,975,1050,75
1755,348,home,1050,1440,390
1756,349,home,0,375,375
1757,349,shop,375,405,30
1758,349,work,405,945,540
1759,349,leisure,945,1080,135
1760,349,home,1080,1440,360
1761,350,home,0,375,375
1762,350,work,375,945,570
1763,350,shop,945,960,15
1764,350,home,960,1440,480
1765,351,home,0,375,375
1766,351,leisure,375,405,30
1767,351,work,405,960,555
1768,351,leisure,960,1020,60
1769,351,home,1020,1440,420
1770,352,home,0,375,375
1771,352,shop,375,420,45
1772,352,work,420,960,540
1773,352,leisure,960,1020,60
1774,352,home,1020,1440,420
1775,353,home,0,375,375
1776,353,shop,375,390,15
1777,353,work,390,975,585
1778,353,education,975,1080,105
1779,353,home,1080,1440,360
1780,354,home,0,405,405
1781,354,work,405,960,555
1782,354,leisure,960,1035,75
1783,354,home,1035,1440,405
1784,355,home,0,375,375
1785,355,leisure,375,435,60
1786,355,work,435,855,420
1787,355,shop,855,945,90
1788,355,home,945,1125,180
1789,355,education,1125,1140,15
1790,355,home,1140,1440,300
1791,356,home,0,405,405
1792,356,leisure,405,465,60
1793,356,work,465,960,495
1794,356,home,960,1440,480
1795,357,home,0,390,390
1796,357,leisure,390,420,30
1797,357,shop,420,435,15
1798,357,leisure,435,465,30
1799,357,work,465,945,480
1800,357,leisure,945,1005,60
1801,357,shop,1005,1020,15
1802,357,home,1020,1440,420
1803,358,home,0,435,435
1804,358,shop,435,495,60
1805,358,work,495,915,420
1806,358,leisure,915,1020,105
1807,358,home,1020,1440,420
1808,359,home,0,375,375
1809,359,shop,375,420,45
1810,359,work,420,1020,600
1811,359,leisure,1020,1095,75
1812,359,home,1095,1440,345
1813,360,home,0,390,390
1814,360,leisure,390,420,30
1815,360,work,420,855,435
1816,360,home,855,1125,270
1817,360,shop,1125,1140,15
1818,360,home,1140,1440,300
1819,361,home,0,375,375
1820,361,work,375,885,510
1821,361,home,885,1065,180
1822,361,education,1065,1080,15
1823,361,home,1080,1440,360
1824,362,home,0,405,405
1825,362,shop,405,420,15
1826,362,work,420,975,555
1827,362,education,975,1080,105
1828,362,home,1080,1440,360
1829,363,home,0,390,390
1830,363,work,390,930,540
1831,363,home,930,1200,270
1832,363,leisure,1200,1260,60
1833,363,home,1260,1440,180
1834,364,home,0,375,375
1835,364,work,375,795,420
1836,364,shop,795,810,15
1837,364,leisure,810,900,90
1838,364,shop,900,960,60
1839,364,home,960,1440,480
1840,365,home,0,390,390
1841,365,work,390,945,555
1842,365,leisure,945,1005,60
1843,365,home,1005,1440,435
1844,366,home,0,375,375
1845,366,work,375,975,600
1846,366,shop,975,990,15
1847,366,home,990,1185,195
1848,366,shop,1185,1200,15
1849,366,home,1200,1440,240
1850,367,home,0,375,375
1851,367,shop,375,420,45
1852,367,work,420,975,555
1853,367,education,975,1080,105
1854,367,home,1080,1440,360
1855,368,home,0,375,375
1856,368,work,375,930,555
1857,368,leisure,930,1020,90
1858,368,home,1020,1440,420
1859,369,home,0,375,375
1860,369,leisure,375,405,30
1861,369,work,405,975,570
1862,369,education,975,1080,105
1863,369,home,1080,1440,360
1864,370,home,0,375,375
1865,370,leisure,375,450,75
1866,370,work,450,960,510
1867,370,shop,960,975,15
1868,370,home,975,1440,465
1869,371,home,0,375,375
1870,371,work,375,810,435
1871,371,education,810,1005,195
1872,371,home,1005,1440,435
1873,372,home,0,420,420
1874,372,work,420,900,480
1875,372,home,900,1440,540
1876,373,home,0,375,375
1877,373,leisure,375,390,15
1878,373,work,390,810,420
1879,373,education,810,945,135
1880,373,shop,945,960,15
1881,373,home,960,1440,480
1882,374,home,0,390,390
1883,374,shop,390,450,60
1884,374,leisure,450,480,30
1885,374,work,480,960,480
1886,374,leisure,960,1020,60
1887,374,home,1020,1440,420
1888,375,home,0,390,390
1889,375,shop,390,420,30
1890,375,work,420,945,525
1891,375,home,945,1440,495
1892,376,home,0,390,390
1893,376,shop,390,450,60
1894,376,work,450,1020,570
1895,376,leisure,1020,1095,75
1896,376,home,1095,1440,345
1897,377,home,0,375,375
1898,377,leisure,375,390,15
1899,377,work,390,825,435
1900,377,education,825,990,165
1901,377,home,990,1185,195
1902,377,leisure,1185,1245,60
1903,377,home,1245,1440,195
1904,378,home,0,375,375
1905,378,work,375,975,600
1906,378,leisure,975,1035,60
1907,378,home,1035,1440,405
1908,379,home,0,375,375
1909,379,shop,375,405,30
1910,379,work,405,960,555
1911,379,shop,960,975,15
1912,379,home,975,1440,465
1913,380,home,0,405,405
1914,380,shop,405,450,45
1915,380,work,450,945,495
1916,380,leisure,945,1005,60
1917,380,home,1005,1440,435
1918,381,home,0,375,375
1919,381,shop,375,420,45
1920,381,work,420,930,510
1921,381,leisure,930,1035,105
1922,381,home,1035,1440,405
1923,382,home,0,375,375
1924,382,shop,375,390,15
1925,382,work,390,960,570
1926,382,shop,960,975,15
1927,382,home,975,1440,465
1928,383,home,0,375,375
1929,383,shop,375,450,75
1930,383,work,450,975,525
1931,383,education,975,1080,105
1932,383,home,1080,1440,360
1933,384,home,0,375,375
1934,384,shop,375,420,45
1935,384,work,420,990,570
1936,384,leisure,990,1065,75
1937,384,home,1065,1440,375
1938,385,home,0,375,375
1939,385,shop,375,420,45
1940,385,work,420,990,570
1941,385,leisure,990,1065,75
1942,385,home,1065,1440,375
1943,386,home,0,375,375
1944,386,work,375,810,435
1945,386,education,810,960,150
1946,386,shop,960,975,15
1947,386,home,975,1440,465
1948,387,home,0,390,390
1949,387,shop,390,420,30
1950,387,work,420,990,570
1951,387,leisure,990,1050,60
1952,387,home,1050,1440,390
1953,388,home,0,375,375
1954,388,shop,375,405,30
1955,388,work,405,900,495
1956,388,shop,900,960,60
1957,388,home,960,1140,180
1958,388,leisure,1140,1275,135
1959,388,home,1275,1440,165
1960,389,home,0,390,390
1961,389,shop,390,420,30
1962,389,work,420,915,495
1963,389,home,915,1155,240
1964,389,shop,1155,1170,15
1965,389,home,1170,1440,270
1966,390,home,0,390,390
1967,390,work,390,945,555
1968,390,shop,945,960,15
1969,390,home,960,1440,480
1970,391,home,0,375,375
1971,391,shop,375,405,30
1972,391,work,405,915,510
1973,391,shop,915,960,45
1974,391,home,960,1155,195
1975,391,shop,1155,1170,15
1976,391,home,1170,1440,270
1977,392,home,0,390,390
1978,392,shop,390,435,45
1979,392,work,435,1005,570
1980,392,leisure,1005,1065,60
1981,392,home,1065,1440,375
1982,393,home,0,405,405
1983,393,shop,405,465,60
1984,393,work,465,990,525
1985,393,leisure,990,1050,60
1986,393,home,1050,1440,390
1987,394,home,0,390,390
1988,394,work,390,810,420
1989,394,shop,810,870,60
1990,394,education,870,990,120
1991,394,home,990,1440,450
1992,395,home,0,375,375
1993,395,work,375,795,420
1994,395,education,795,1005,210
1995,395,home,1005,1185,180
1996,395,shop,1185,1200,15
1997,395,home,1200,1440,240
1998,396,home,0,390,390
1999,396,work,390,810,420
2000,396,education,810,990,180
2001,396,home,990,1230,240
2002,396,leisure,1230,1290,60
2003,396,home,1290,1440,150
2004,397,home,0,405,405
2005,397,shop,405,465,60
2006,397,work,465,975,510
2007,397,leisure,975,1080,105
2008,397,home,1080,1440,360
2009,398,home,0,375,375
2010,398,shop,375,435,60
2011,398,work,435,945,510
2012,398,leisure,945,1020,75
2013,398,home,1020,1440,420
2014,399,home,0,405,405
2015,399,work,405,975,570
2016,399,education,975,1065,90
2017,399,home,1065,1440,375
2018,400,home,0,405,405
2019,400,shop,405,465,60
2020,400,education,465,510,45
2021,400,work,510,975,465
2022,400,education,975,1080,105
2023,400,home,1080,1440,360
2024,401,home,0,420,420
2025,401,leisure,420,450,30
2026,401,work,450,945,495
2027,401,shop,945,960,15
2028,401,home,960,1140,180
2029,401,leisure,1140,1215,75
2030,401,home,1215,1440,225
2031,402,home,0,375,375
2032,402,shop,375,405,30
2033,402,work,405,915,510
2034,402,leisure,915,990,75
2035,402,home,990,1440,450
2036,403,home,0,375,375
2037,403,work,375,960,585
2038,403,home,960,1155,195
2039,403,shop,1155,1170,15
2040,403,home,1170,1440,270
2041,404,home,0,405,405
2042,404,shop,405,420,15
2043,404,work,420,945,525
2044,404,shop,945,960,15
2045,404,home,960,1140,180
2046,404,leisure,1140,1230,90
2047,404,home,1230,1440,210
2048,405,home,0,390,390
2049,405,shop,390,405,15
2050,405,work,405,945,540
2051,405,shop,945,960,15
2052,405,home,960,1170,210
2053,405,leisure,1170,1230,60
2054,405,home,1230,1440,210
2055,406,home,0,375,375
2056,406,shop,375,390,15
2057,406,work,390,975,585
2058,406,education,975,1080,105
2059,406,home,1080,1440,360
2060,407,home,0,390,390
2061,407,shop,390,405,15
2062,407,work,405,1020,615
2063,407,leisure,1020,1080,60
2064,407,home,1080,1440,360
2065,408,home,0,375,375
2066,408,shop,375,390,15
2067,408,work,390,900,510
2068,408,shop,900,960,60
2069,408,home,960,1440,480
2070,409,home,0,405,405
2071,409,work,405,975,570
2072,409,home,975,1440,465
2073,410,home,0,390,390
2074,410,shop,390,405,15
2075,410,work,405,930,525
2076,410,home,930,1020,90
2077,410,shop,1020,1035,15
2078,410,home,1035,1440,405
2079,411,home,0,375,375
2080,411,shop,375,420,45
2081,411,work,420,975,555
2082,411,education,975,1080,105
2083,411,home,1080,1440,360
2084,412,home,0,390,390
2085,412,leisure,390,405,15
2086,412,work,405,930,525
2087,412,shop,930,960,30
2088,412,home,960,1440,480
2089,413,home,0,390,390
2090,413,shop,390,405,15
2091,413,work,405,930,525
2092,413,leisure,930,990,60
2093,413,home,990,1440,450
2094,414,home,0,390,390
2095,414,shop,390,405,15
2096,414,work,405,930,525
2097,414,leisure,930,1020,90
2098,414,home,1020,1440,420
2099,415,home,0,405,405
2100,415,work,405,975,570
2101,415,education,975,1080,105
2102,415,home,1080,1440,360
2103,416,home,0,405,405
2104,416,work,405,975,570
2105,416,leisure,975,1050,75
2106,416,home,1050,1440,390
2107,417,home,0,405,405
2108,417,shop,405,465,60
2109,417,work,465,960,495
2110,417,leisure,960,1035,75
2111,417,home,1035,1440,405
2112,418,home,0,405,405
2113,418,work,405,900,495
2114,418,shop,900,960,60
2115,418,home,960,1440,480
2116,419,home,0,390,390
2117,419,work,390,825,435
2118,419,education,825,975,150
2119,419,shop,975,990,15
2120,419,home,990,1440,450
2121,420,home,0,390,390
2122,420,work,390,810,420
2123,420,shop,810,885,75
2124,420,home,885,1080,195
2125,420,leisure,1080,1155,75
2126,420,home,1155,1440,285
2127,421,home,0,390,390
2128,421,shop,390,450,60
2129,421,work,450,915,465
2130,421,home,915,1440,525
2131,422,home,0,390,390
2132,422,shop,390,420,30
2133,422,work,420,960,540
2134,422,leisure,960,1065,105
2135,422,home,1065,1440,375
2136,423,home,0,405,405
2137,423,shop,405,465,60
2138,423,work,465,990,525
2139,423,leisure,990,1035,45
2140,423,home,1035,1440,405
2141,424,home,0,390,390
2142,424,shop,390,420,30
2143,424,work,420,990,570
2144,424,education,990,1065,75
2145,424,home,1065,1440,375
2146,425,home,0,375,375
2147,425,shop,375,405,30
2148,425,work,405,960,555
2149,425,leisure,960,1020,60
2150,425,home,1020,1440,420
2151,426,home,0,375,375
2152,426,shop,375,405,30
2153,426,work,405,825,420
2154,426,education,825,990,165
2155,426,home,990,1440,450
2156,427,home,0,375,375
2157,427,shop,375,435,60
2158,427,work,435,975,540
2159,427,education,975,1080,105
2160,427,home,1080,1440,360
2161,428,home,0,375,375
2162,428,shop,375,405,30
2163,428,work,405,945,540
2164,428,leisure,945,1005,60
2165,428,home,1005,1440,435
2166,429,home,0,405,405
2167,429,shop,405,450,45
2168,429,work,450,990,540
2169,429,education,990,1080,90
2170,429,home,1080,1440,360
2171,430,home,0,405,405
2172,430,shop,405,435,30
2173,430,work,435,960,525
2174,430,leisure,960,1020,60
2175,430,home,1020,1440,420
2176,431,home,0,375,375
2177,431,work,375,795,420
2178,431,education,795,930,135
2179,431,leisure,930,1020,90
2180,431,home,1020,1440,420
2181,432,home,0,375,375
2182,432,shop,375,420,45
2183,432,education,420,540,120
2184,432,work,540,1005,465
2185,432,leisure,1005,1095,90
2186,432,home,1095,1440,345
2187,433,home,0,375,375
2188,433,leisure,375,420,45
2189,433,work,420,945,525
2190,433,home,945,1035,90
2191,433,shop,1035,1050,15
2192,433,home,1050,1440,390
2193,434,home,0,375,375
2194,434,shop,375,405,30
2195,434,work,405,915,510
2196,434,home,915,1080,165
2197,434,shop,1080,1095,15
2198,434,home,1095,1440,345
2199,435,home,0,390,390
2200,435,shop,390,450,60
2201,435,work,450,975,525
2202,435,education,975,1080,105
2203,435,home,1080,1440,360
2204,436,home,0,375,375
2205,436,shop,375,390,15
2206,436,work,390,975,585
2207,436,education,975,1080,105
2208,436,home,1080,1440,360
2209,437,home,0,405,405
2210,437,leisure,405,435,30
2211,437,work,435,915,480
2212,437,shop,915,960,45
2213,437,home,960,1005,45
2214,437,shop,1005,1020,15
2215,437,home,1020,1440,420
2216,438,home,0,390,390
2217,438,leisure,390,420,30
2218,438,work,420,885,465
2219,438,home,885,1080,195
2220,438,shop,1080,1095,15
2221,438,home,1095,1440,345
2222,439,home,0,375,375
2223,439,work,375,1005,630
2224,439,leisure,1005,1080,75
2225,439,home,1080,1440,360
2226,440,home,0,405,405
2227,440,leisure,405,465,60
2228,440,work,465,1005,540
2229,440,education,1005,1080,75
2230,440,home,1080,1440,360
2231,441,home,0,375,375
2232,441,leisure,375,405,30
2233,441,work,405,885,480
2234,441,shop,885,960,75
2235,441,home,960,1440,480
2236,442,home,0,375,375
2237,442,work,375,990,615
2238,442,leisure,990,1065,75
2239,442,home,1065,1440,375
2240,443,home,0,375,375
2241,443,work,375,990,615
2242,443,leisure,990,1050,60
2243,443,home,1050,1440,390
2244,444,home,0,375,375
2245,444,work,375,795,420
2246,444,education,795,915,120
2247,444,leisure,915,1020,105
2248,444,home,1020,1440,420
2249,445,home,0,390,390
2250,445,leisure,390,420,30
2251,445,work,420,990,570
2252,445,leisure,990,1050,60
2253,445,home,1050,1440,390
2254,446,home,0,405,405
2255,446,shop,405,420,15
2256,446,work,420,975,555
2257,446,education,975,1080,105
2258,446,home,1080,1440,360
2259,447,home,0,375,375
2260,447,shop,375,405,30
2261,447,education,405,525,120
2262,447,work,525,1005,480
2263,447,leisure,1005,1095,90
2264,447,home,1095,1440,345
2265,448,home,0,390,390
2266,448,work,390,990,600
2267,448,leisure,990,1065,75
2268,448,home,1065,1440,375
2269,449,home,0,375,375
2270,449,leisure,375,405,30
2271,449,work,405,960,555
2272,449,home,960,1440,480
2273,450,home,0,390,390
2274,450,shop,390,435,45
2275,450,work,435,975,540
2276,450,education,975,1080,105
2277,450,home,1080,1440,360
2278,451,home,0,405,405
2279,451,work,405,975,570
2280,451,leisure,975,1065,90
2281,451,home,1065,1440,375
2282,452,home,0,390,390
2283,452,shop,390,450,60
2284,452,work,450,990,540
2285,452,education,990,1080,90
2286,452,home,1080,1440,360
2287,453,home,0,375,375
2288,453,shop,375,390,15
2289,453,work,390,810,420
2290,453,education,810,930,120
2291,453,shop,930,960,30
2292,453,home,960,1440,480
2293,454,home,0,390,390
2294,454,shop,390,450,60
2295,454,work,450,975,525
2296,454,education,975,1080,105
2297,454,home,1080,1440,360
2298,455,home,0,375,375
2299,455,work,375,795,420
2300,455,education,795,990,195
2301,455,shop,990,1005,15
2302,455,home,1005,1440,435
2303,456,home,0,375,375
2304,456,shop,375,390,15
2305,456,work,390,810,420
2306,456,education,810,975,165
2307,456,home,975,1035,60
2308,456,shop,1035,1050,15
2309,456,home,1050,1440,390
2310,457,home,0,375,375
2311,457,leisure,375,435,60
2312,457,work,435,975,540
2313,457,shop,975,990,15
2314,457,home,990,1440,450
2315,458,home,0,405,405
2316,458,work,405,930,525
2317,458,shop,930,960,30
2318,458,home,960,1185,225
2319,458,leisure,1185,1245,60
2320,458,home,1245,1440,195
2321,459,home,0,390,390
2322,459,shop,390,435,45
2323,459,work,435,975,540
2324,459,leisure,975,1050,75
2325,459,home,1050,1440,390
2326,460,home,0,405,405
2327,460,leisure,405,465,60
2328,460,work,465,990,525
2329,460,education,990,1080,90
2330,460,home,1080,1440,360
2331,461,home,0,390,390
2332,461,shop,390,450,60
2333,461,education,450,540,90
2334,461,work,540,990,450
2335,461,leisure,990,1050,60
2336,461,home,1050,1440,390
2337,462,home,0,390,390
2338,462,shop,390,435,45
2339,462,work,435,960,525
2340,462,leisure,960,1035,75
2341,462,home,1035,1440,405
2342,463,home,0,390,390
2343,463,work,390,975,585
2344,463,education,975,1080,105
2345,463,home,1080,1440,360
2346,464,home,0,375,375
2347,464,work,375,810,435
2348,464,education,810,1005,195
2349,464,home,1005,1440,435
2350,465,home,0,375,375
2351,465,shop,375,405,30
2352,465,work,405,1035,630
2353,465,education,1035,1080,45
2354,465,home,1080,1440,360
2355,466,home,0,390,390
2356,466,work,390,810,420
2357,466,education,810,1020,210
2358,466,home,1020,1440,420
2359,467,home,0,405,405
2360,467,work,405,945,540
2361,467,leisure,945,1005,60
2362,467,home,1005,1440,435
2363,468,home,0,375,375
2364,468,shop,375,390,15
2365,468,education,390,405,15
2366,468,work,405,825,420
2367,468,education,825,1050,225
2368,468,home,1050,1290,240
2369,468,leisure,1290,1335,45
2370,468,home,1335,1440,105
2371,469,home,0,390,390
2372,469,shop,390,420,30
2373,469,work,420,990,570
2374,469,education,990,1080,90
2375,469,home,1080,1440,360
2376,470,home,0,375,375
2377,470,leisure,375,435,60
2378,470,work,435,885,450
2379,470,shop,885,945,60
2380,470,home,945,1140,195
2381,470,education,1140,1155,15
2382,470,home,1155,1440,285
2383,471,home,0,375,375
2384,471,shop,375,390,15
2385,471,work,390,990,600
2386,471,education,990,1080,90
2387,471,home,1080,1440,360
2388,472,home,0,405,405
2389,472,shop,405,420,15
2390,472,work,420,945,525
2391,472,shop,945,960,15
2392,472,home,960,1140,180
2393,472,shop,1140,1155,15
2394,472,home,1155,1440,285
2395,473,home,0,375,375
2396,473,work,375,1005,630
2397,473,shop,1005,1020,15
2398,473,home,1020,1440,420
2399,474,home,0,390,390
2400,474,shop,390,405,15
2401,474,work,405,990,585
2402,474,education,990,1080,90
2403,474,home,1080,1440,360
2404,475,home,0,390,390
2405,475,leisure,390,435,45
2406,475,work,435,990,555
2407,475,education,990,1080,90
2408,475,home,1080,1440,360
2409,476,home,0,390,390
2410,476,shop,390,435,45
2411,476,work,435,975,540
2412,476,leisure,975,1050,75
2413,476,home,1050,1440,390
2414,477,home,0,390,390
2415,477,leisure,390,420,30
2416,477,work,420,975,555
2417,477,education,975,1080,105
2418,477,home,1080,1440,360
2419,478,home,0,375,375
2420,478,shop,375,390,15
2421,478,work,390,810,420
2422,478,education,810,960,150
2423,478,leisure,960,1020,60
2424,478,home,1020,1440,420
2425,479,home,0,390,390
2426,479,work,390,945,555
2427,479,leisure,945,1035,90
2428,479,home,1035,1440,405
2429,480,home,0,375,375
2430,480,work,375,795,420
2431,480,education,795,1020,225
2432,480,home,1020,1215,195
2433,480,leisure,1215,1305,90
2434,480,home,1305,1440,135
2435,481,home,0,390,390
2436,481,work,390,810,420
2437,481,education,810,975,165
2438,481,shop,975,990,15
2439,481,home,990,1440,450
2440,482,home,0,405,405
2441,482,work,405,930,525
2442,482,shop,930,960,30
2443,482,home,960,1440,480
2444,483,home,0,375,375
2445,483,work,375,810,435
2446,483,education,810,930,120
2447,483,leisure,930,1005,75
2448,483,home,1005,1065,60
2449,483,shop,1065,1080,15
2450,483,home,1080,1440,360
2451,484,home,0,375,375
2452,484,shop,375,390,15
2453,484,work,390,960,570
2454,484,shop,960,975,15
2455,484,home,975,1155,180
2456,484,leisure,1155,1200,45
2457,484,home,1200,1440,240
2458,485,home,0,375,375
2459,485,shop,375,405,30
2460,485,work,405,945,540
2461,485,shop,945,960,15
2462,485,home,960,1440,480
2463,486,home,0,375,375
2464,486,leisure,375,420,45
2465,486,work,420,1005,585
2466,486,education,1005,1080,75
2467,486,home,1080,1440,360
2468,487,home,0,375,375
2469,487,shop,375,420,45
2470,487,work,420,930,510
2471,487,leisure,930,1020,90
2472,487,home,1020,1440,420
2473,488,home,0,375,375
2474,488,shop,375,405,30
2475,488,work,405,960,555
2476,488,leisure,960,1035,75
2477,488,home,1035,1440,405
2478,489,home,0,390,390
2479,489,shop,390,420,30
2480,489,work,420,945,525
2481,489,leisure,945,1005,60
2482,489,home,1005,1440,435
2483,490,home,0,390,390
2484,490,shop,390,435,45
2485,490,work,435,975,540
2486,490,leisure,975,1050,75
2487,490,home,1050,1440,390
2488,491,home,0,390,390
2489,491,shop,390,435,45
2490,491,work,435,960,525
2491,491,leisure,960,1035,75
2492,491,home,1035,1440,405
2493,492,home,0,420,420
2494,492,leisure,420,435,15
2495,492,work,435,915,480
2496,492,leisure,915,975,60
2497,492,home,975,1155,180
2498,492,shop,1155,1170,15
2499,492,home,1170,1440,270
2500,493,home,0,375,375
2501,493,shop,375,420,45
2502,493,work,420,975,555
2503,493,education,975,1080,105
2504,493,home,1080,1260,180
2505,493,leisure,1260,1320,60
2506,493,home,1320,1440,120
2507,494,home,0,375,375
2508,494,work,375,795,420
2509,494,education,795,990,195
2510,494,home,990,1440,450
2511,495,home,0,375,375
2512,495,shop,375,435,60
2513,495,work,435,960,525
2514,495,leisure,960,1035,75
2515,495,home,1035,1440,405
2516,496,home,0,390,390
2517,496,leisure,390,435,45
2518,496,work,435,915,480
2519,496,shop,915,960,45
2520,496,home,960,1440,480
2521,497,home,0,375,375
2522,497,work,375,810,435
2523,497,education,810,990,180
2524,497,home,990,1440,450
2525,498,home,0,375,375
2526,498,work,375,1005,630
2527,498,shop,1005,1020,15
2528,498,home,1020,1200,180
2529,498,leisure,1200,1260,60
2530,498,home,1260,1440,180
2531,499,home,0,390,390
2532,499,leisure,390,435,45
2533,499,work,435,915,480
2534,499,shop,915,960,45
2535,499,home,960,1440,480
2536,500,home,0,390,390
2537,500,work,390,810,420
2538,500,education,810,990,180
2539,500,home,990,1170,180
2540,500,leisure,1170,1260,90
2541,500,home,1260,1440,180
2542,501,home,0,405,405
2543,501,leisure,405,435,30
2544,501,work,435,915,480
2545,501,shop,915,960,45
2546,501,home,960,1440,480
2547,502,home,0,435,435
2548,502,work,435,960,525
2549,502,shop,960,975,15
2550,502,home,975,1440,465
2551,503,home,0,390,390
2552,503,leisure,390,450,60
2553,503,work,450,1005,555
2554,503,education,1005,1080,75
2555,503,home,1080,1440,360
2556,504,home,0,390,390
2557,504,leisure,390,405,15
2558,504,work,405,915,510
2559,504,shop,915,960,45
2560,504,home,960,1440,480
2561,505,home,0,375,375
2562,505,leisure,375,390,15
2563,505,work,390,945,555
2564,505,leisure,945,1005,60
2565,505,home,1005,1440,435
2566,506,home,0,390,390
2567,506,shop,390,405,15
2568,506,work,405,930,525
2569,506,leisure,930,945,15
2570,506,shop,945,960,15
2571,506,home,960,1440,480
2572,507,home,0,390,390
2573,507,shop,390,450,60
2574,507,work,450,975,525
2575,507,leisure,975,1035,60
2576,507,home,1035,1440,405
2577,508,home,0,375,375
2578,508,shop,375,435,60
2579,508,work,435,1005,570
2580,508,education,1005,1080,75
2581,508,home,1080,1440,360
2582,509,home,0,420,420
2583,509,shop,420,465,45
2584,509,work,465,930,465
2585,509,shop,930,960,30
2586,509,home,960,1155,195
2587,509,shop,1155,1170,15
2588,509,home,1170,1440,270
2589,510,home,0,405,405
2590,510,shop,405,435,30
2591,510,work,435,900,465
2592,510,shop,900,960,60
2593,510,home,960,1440,480
2594,511,home,0,405,405
2595,511,work,405,825,420
2596,511,home,825,1065,240
2597,511,education,1065,1080,15
2598,511,home,1080,1440,360
2599,512,home,0,375,375
2600,512,work,375,945,570
2601,512,home,945,1440,495
2602,513,home,0,375,375
2603,513,shop,375,390,15
2604,513,work,390,960,570
2605,513,leisure,960,1020,60
2606,513,home,1020,1440,420
2607,514,home,0,450,450
2608,514,shop,450,480,30
2609,514,work,480,960,480
2610,514,home,960,1440,480
2611,515,home,0,375,375
2612,515,work,375,795,420
2613,515,education,795,1005,210
2614,515,home,1005,1440,435
2615,516,home,0,390,390
2616,516,work,390,975,585
2617,516,leisure,975,1035,60
2618,516,home,1035,1440,405
2619,517,home,0,375,375
2620,517,shop,375,420,45
2621,517,work,420,975,555
2622,517,education,975,1080,105
2623,517,home,1080,1440,360
2624,518,home,0,375,375
2625,518,work,375,975,600
2626,518,education,975,1080,105
2627,518,home,1080,1440,360
2628,519,home,0,390,390
2629,519,work,390,810,420
2630,519,education,810,1005,195
2631,519,home,1005,1440,435
2632,520,home,0,375,375
2633,520,shop,375,405,30
2634,520,work,405,945,540
2635,520,leisure,945,1035,90
2636,520,shop,1035,1050,15
2637,520,home,1050,1440,390
2638,521,home,0,390,390
2639,521,work,390,930,540
2640,521,leisure,930,1020,90
2641,521,shop,1020,1035,15
2642,521,home,1035,1440,405
2643,522,home,0,375,375
2644,522,work,375,825,450
2645,522,education,825,990,165
2646,522,home,990,1440,450
2647,523,home,0,390,390
2648,523,shop,390,450,60
2649,523,work,450,990,540
2650,523,education,990,1080,90
2651,523,home,1080,1440,360
2652,524,home,0,375,375
2653,524,shop,375,390,15
2654,524,education,390,480,90
2655,524,work,480,945,465
2656,524,leisure,945,1005,60
2657,524,home,1005,1440,435
2658,525,home,0,375,375
2659,525,shop,375,435,60
2660,525,work,435,915,480
2661,525,home,915,1215,300
2662,525,leisure,1215,1275,60
2663,525,home,1275,1440,165
2664,526,home,0,375,375
2665,526,shop,375,435,60
2666,526,work,435,1005,570
2667,526,education,1005,1080,75
2668,526,home,1080,1440,360
2669,527,home,0,375,375
2670,527,leisure,375,390,15
2671,527,work,390,810,420
2672,527,education,810,945,135
2673,527,shop,945,960,15
2674,527,home,960,1170,210
2675,527,leisure,1170,1215,45
2676,527,home,1215,1440,225
2677,528,home,0,375,375
2678,528,work,375,975,600
2679,528,education,975,1080,105
2680,528,home,1080,1440,360
2681,529,home,0,405,405
2682,529,work,405,900,495
2683,529,shop,900,960,60
2684,529,home,960,1440,480
2685,530,home,0,375,375
2686,530,shop,375,390,15
2687,530,work,390,885,495
2688,530,shop,885,945,60
2689,530,home,945,1125,180
2690,530,leisure,1125,1185,60
2691,530,home,1185,1440,255
2692,531,home,0,375,375
2693,531,work,375,960,585
2694,531,leisure,960,1020,60
2695,531,home,1020,1440,420
2696,532,home,0,375,375
2697,532,work,375,810,435
2698,532,education,810,990,180
2699,532,shop,990,1005,15
2700,532,home,1005,1440,435
2701,533,home,0,390,390
2702,533,shop,390,450,60
2703,533,work,450,900,450
2704,533,home,900,1080,180
2705,533,leisure,1080,1140,60
2706,533,home,1140,1440,300
2707,534,home,0,405,405
2708,534,shop,405,450,45
2709,534,work,450,975,525
2710,534,home,975,1440,465
2711,535,home,0,375,375
2712,535,work,375,795,420
2713,535,home,795,990,195
2714,535,shop,990,1005,15
2715,535,home,1005,1050,45
2716,535,shop,1050,1065,15
2717,535,home,1065,1440,375
2718,536,home,0,375,375
2719,536,leisure,375,405,30
2720,536,work,405,1005,600
2721,536,education,1005,1080,75
2722,536,home,1080,1440,360
2723,537,home,0,405,405
2724,537,work,405,960,555
2725,537,shop,960,975,15
2726,537,home,975,1440,465
2727,538,home,0,375,375
2728,538,shop,375,435,60
2729,538,education,435,540,105
2730,538,work,540,990,450
2731,538,education,990,1080,90
2732,538,home,1080,1440,360
2733,539,home,0,390,390
2734,539,work,390,975,585
2735,539,education,975,1080,105
2736,539,home,1080,1440,360
2737,540,home,0,375,375
2738,540,leisure,375,390,15
2739,540,work,390,990,600
2740,540,shop,990,1005,15
2741,540,home,1005,1440,435
2742,541,home,0,375,375
2743,541,leisure,375,435,60
2744,541,work,435,990,555
2745,541,shop,990,1005,15
2746,541,home,1005,1440,435
2747,542,home,0,375,375
2748,542,work,375,945,570
2749,542,shop,945,960,15
2750,542,home,960,1140,180
2751,542,leisure,1140,1200,60
2752,542,home,1200,1440,240
2753,543,home,0,390,390
2754,543,work,390,930,540
2755,543,shop,930,960,30
2756,543,home,960,1440,480
2757,544,home,0,375,375
2758,544,work,375,990,615
2759,544,education,990,1080,90
2760,544,home,1080,1440,360
2761,545,home,0,375,375
2762,545,shop,375,435,60
2763,545,work,435,990,555
2764,545,education,990,1080,90
2765,545,home,1080,1440,360
2766,546,home,0,390,390
2767,546,shop,390,405,15
2768,546,work,405,1005,600
2769,546,leisure,1005,1035,30
2770,546,home,1035,1440,405
2771,547,home,0,375,375
2772,547,work,375,960,585
2773,547,leisure,960,1020,60
2774,547,home,1020,1440,420
2775,548,home,0,375,375
2776,548,shop,375,420,45
2777,548,work,420,990,570
2778,548,education,990,1080,90
2779,548,home,1080,1440,360
2780,549,home,0,375,375
2781,549,work,375,810,435
2782,549,education,810,1020,210
2783,549,home,1020,1440,420
2784,550,home,0,390,390
2785,550,shop,390,405,15
2786,550,work,405,1020,615
2787,550,leisure,1020,1095,75
2788,550,home,1095,1440,345
2789,551,home,0,390,390
2790,551,shop,390,450,60
2791,551,leisure,450,510,60
2792,551,work,510,975,465
2793,551,education,975,1080,105
2794,551,home,1080,1440,360
2795,552,home,0,375,375
2796,552,work,375,795,420
2797,552,education,795,915,120
2798,552,leisure,915,1035,120
2799,552,home,1035,1440,405
2800,553,home,0,405,405
2801,553,shop,405,450,45
2802,553,work,450,975,525
2803,553,leisure,975,1050,75
2804,553,home,1050,1440,390
2805,554,home,0,405,405
2806,554,work,405,825,420
2807,554,education,825,1050,225
2808,554,home,1050,1440,390
2809,555,home,0,405,405
2810,555,leisure,405,420,15
2811,555,work,420,930,510
2812,555,leisure,930,990,60
2813,555,home,990,1440,450
2814,556,home,0,390,390
2815,556,shop,390,405,15
2816,556,work,405,1005,600
2817,556,education,1005,1080,75
2818,556,home,1080,1440,360
2819,557,home,0,375,375
2820,557,leisure,375,435,60
2821,557,work,435,1020,585
2822,557,education,1020,1080,60
2823,557,home,1080,1440,360
2824,558,home,0,375,375
2825,558,shop,375,390,15
2826,558,education,390,465,75
2827,558,work,465,945,480
2828,558,leisure,945,1065,120
2829,558,home,1065,1440,375
2830,559,home,0,375,375
2831,559,work,375,810,435
2832,559,education,810,930,120
2833,559,shop,930,960,30
2834,559,home,960,1440,480
2835,560,home,0,390,390
2836,560,shop,390,405,15
2837,560,work,405,990,585
2838,560,education,990,1080,90
2839,560,home,1080,1440,360
2840,561,home,0,390,390
2841,561,shop,390,420,30
2842,561,work,420,900,480
2843,561,shop,900,960,60
2844,561,home,960,1170,210
2845,561,education,1170,1185,15
2846,561,home,1185,1440,255
2847,562,home,0,375,375
2848,562,shop,375,405,30
2849,562,work,405,990,585
2850,562,leisure,990,1095,105
2851,562,home,1095,1440,345
2852,563,home,0,390,390
2853,563,work,390,810,420
2854,563,education,810,930,120
2855,563,shop,930,960,30
2856,563,home,960,1185,225
2857,563,leisure,1185,1275,90
2858,563,home,1275,1440,165
2859,564,home,0,405,405
2860,564,shop,405,465,60
2861,564,work,465,915,450
2862,564,leisure,915,990,75
2863,564,home,990,1440,450
2864,565,home,0,420,420
2865,565,work,420,1005,585
2866,565,education,1005,1080,75
2867,565,home,1080,1440,360
2868,566,home,0,375,375
2869,566,work,375,810,435
2870,566,education,810,990,180
2871,566,home,990,1440,450
2872,567,home,0,375,375
2873,567,work,375,795,420
2874,567,education,795,915,120
2875,567,shop,915,960,45
2876,567,home,960,1440,480
2877,568,home,0,375,375
2878,568,work,375,795,420
2879,568,education,795,975,180
2880,568,home,975,1170,195
2881,568,shop,1170,1185,15
2882,568,home,1185,1440,255
2883,569,home,0,375,375
2884,569,leisure,375,390,15
2885,569,work,390,990,600
2886,569,leisure,990,1065,75
2887,569,home,1065,1440,375
2888,570,home,0,375,375
2889,570,leisure,375,390,15
2890,570,work,390,1005,615
2891,570,education,1005,1080,75
2892,570,home,1080,1440,360
2893,571,home,0,390,390
2894,571,shop,390,420,30
2895,571,work,420,975,555
2896,571,leisure,975,1035,60
2897,571,home,1035,1440,405
2898,572,home,0,405,405
2899,572,work,405,915,510
2900,572,shop,915,960,45
2901,572,home,960,1440,480
2902,573,home,0,390,390
2903,573,leisure,390,405,15
2904,573,work,405,765,360
2905,573,shop,765,825,60
2906,573,work,825,1185,360
2907,573,home,1185,1440,255
2908,574,home,0,405,405
2909,574,shop,405,420,15
2910,574,work,420,825,405
2911,574,education,825,990,165
2912,574,shop,990,1005,15
2913,574,home,1005,1440,435
2914,575,home,0,390,390
2915,575,shop,390,405,15
2916,575,work,405,795,390
2917,575,education,795,915,120
2918,575,shop,915,960,45
2919,575,home,960,1440,480
2920,576,home,0,405,405
2921,576,work,405,960,555
2922,576,shop,960,975,15
2923,576,home,975,1080,105
2924,576,shop,1080,1095,15
2925,576,home,1095,1440,345
2926,577,home,0,390,390
2927,577,work,390,1020,630
2928,577,leisure,1020,1095,75
2929,577,shop,1095,1110,15
2930,577,home,1110,1440,330
2931,578,home,0,390,390
2932,578,work,390,975,585
2933,578,shop,975,990,15
2934,578,home,990,1440,450
2935,579,home,0,390,390
2936,579,shop,390,435,45
2937,579,education,435,510,75
2938,579,work,510,930,420
2939,579,leisure,930,990,60
2940,579,home,990,1440,450
2941,580,home,0,375,375
2942,580,shop,375,420,45
2943,580,work,420,975,555
2944,580,education,975,1080,105
2945,580,home,1080,1440,360
2946,581,home,0,390,390
2947,581,shop,390,435,45
2948,581,work,435,975,540
2949,581,education,975,1080,105
2950,581,home,1080,1440,360
2951,582,home,0,375,375
2952,582,leisure,375,435,60
2953,582,work,435,930,495
2954,582,shop,930,960,30
2955,582,home,960,1440,480
2956,583,home,0,375,375
2957,583,leisure,375,405,30
2958,583,work,405,945,540
2959,583,shop,945,960,15
2960,583,home,960,1440,480
2961,584,home,0,405,405
2962,584,work,405,900,495
2963,584,shop,900,960,60
2964,584,home,960,1155,195
2965,584,education,1155,1170,15
2966,584,home,1170,1440,270
2967,585,home,0,375,375
2968,585,work,375,930,555
2969,585,shop,930,960,30
2970,585,home,960,1440,480
2971,586,home,0,420,420
2972,586,leisure,420,480,60
2973,586,work,480,1020,540
2974,586,education,1020,1080,60
2975,586,home,1080,1440,360
2976,587,home,0,375,375
2977,587,work,375,930,555
2978,587,leisure,930,990,60
2979,587,home,990,1440,450
2980,588,home,0,390,390
2981,588,shop,390,435,45
2982,588,work,435,975,540
2983,588,education,975,1080,105
2984,588,home,1080,1440,360
2985,589,home,0,375,375
2986,589,shop,375,405,30
2987,589,work,405,825,420
2988,589,education,825,945,120
2989,589,leisure,945,1005,60
2990,589,home,1005,1440,435
2991,590,home,0,375,375
2992,590,shop,375,435,60
2993,590,work,435,960,525
2994,590,leisure,960,1035,75
2995,590,home,1035,1440,405
2996,591,home,0,375,375
2997,591,shop,375,420,45
2998,591,work,420,975,555
2999,591,leisure,975,1050,75
3000,591,home,1050,1440,390
3001,592,home,0,375,375
3002,592,shop,375,420,45
3003,592,work,420,960,540
3004,592,leisure,960,1050,90
3005,592,home,1050,1440,390
3006,593,home,0,390,390
3007,593,shop,390,405,15
3008,593,work,405,990,585
3009,593,leisure,990,1080,90
3010,593,home,1080,1440,360
3011,594,home,0,375,375
3012,594,work,375,795,420
3013,594,shop,795,855,60
3014,594,education,855,1050,195
3015,594,home,1050,1440,390
3016,595,home,0,390,390
3017,595,shop,390,420,30
3018,595,work,420,975,555
3019,595,leisure,975,1035,60
3020,595,home,1035,1440,405
3021,596,home,0,435,435
3022,596,work,435,915,480
3023,596,shop,915,960,45
3024,596,home,960,1110,150
3025,596,shop,1110,1125,15
3026,596,home,1125,1440,315
3027,597,home,0,390,390
3028,597,leisure,390,405,15
3029,597,work,405,795,390
3030,597,shop,795,945,150
3031,597,home,945,1440,495
3032,598,home,0,420,420
3033,598,shop,420,465,45
3034,598,work,465,930,465
3035,598,leisure,930,990,60
3036,598,home,990,1440,450
3037,599,home,0,375,375
3038,599,shop,375,405,30
3039,599,work,405,960,555
3040,599,home,960,1440,480
3041,600,home,0,375,375
3042,600,shop,375,390,15
3043,600,leisure,390,420,30
3044,600,work,420,990,570
3045,600,education,990,1080,90
3046,600,shop,1080,1095,15
3047,600,home,1095,1440,345
3048,601,home,0,390,390
3049,601,shop,390,435,45
3050,601,work,435,945,510
3051,601,leisure,945,1020,75
3052,601,home,1020,1440,420
3053,602,home,0,375,375
3054,602,shop,375,420,45
3055,602,leisure,420,480,60
3056,602,work,480,1005,525
3057,602,education,1005,1080,75
3058,602,home,1080,1440,360
3059,603,home,0,390,390
3060,603,work,390,825,435
3061,603,shop,825,885,60
3062,603,home,885,1065,180
3063,603,leisure,1065,1125,60
3064,603,home,1125,1440,315
3065,604,home,0,405,405
3066,604,shop,405,435,30
3067,604,home,435,555,120
3068,604,education,555,675,120
3069,604,work,675,1080,405
3070,604,home,1080,1440,360
3071,605,home,0,375,375
3072,605,work,375,810,435
3073,605,education,810,990,180
3074,605,leisure,990,1080,90
3075,605,home,1080,1440,360
3076,606,home,0,390,390
3077,606,leisure,390,450,60
3078,606,work,450,960,510
3079,606,leisure,960,990,30
3080,606,home,990,1440,450
3081,607,home,0,375,375
3082,607,work,375,795,420
3083,607,education,795,930,135
3084,607,shop,930,960,30
3085,607,home,960,1170,210
3086,607,shop,1170,1185,15
3087,607,home,1185,1440,255
3088,608,home,0,375,375
3089,608,leisure,375,390,15
3090,608,work,390,930,540
3091,608,shop,930,960,30
3092,608,home,960,990,30
3093,608,leisure,990,1005,15
3094,608,home,1005,1215,210
3095,608,leisure,1215,1275,60
3096,608,home,1275,1440,165
3097,609,home,0,405,405
3098,609,leisure,405,450,45
3099,609,work,450,885,435
3100,609,shop,885,960,75
3101,609,home,960,1440,480
3102,610,home,0,390,390
3103,610,leisure,390,405,15
3104,610,work,405,825,420
3105,610,education,825,960,135
3106,610,shop,960,975,15
3107,610,home,975,1290,315
3108,610,leisure,1290,1350,60
3109,610,home,1350,1440,90
3110,611,home,0,375,375
3111,611,shop,375,390,15
3112,611,home,390,510,120
3113,611,leisure,510,540,30
3114,611,work,540,960,420
3115,611,home,960,1440,480
3116,612,home,0,390,390
3117,612,work,390,990,600
3118,612,leisure,990,1050,60
3119,612,home,1050,1440,390
3120,613,home,0,390,390
3121,613,work,390,1050,660
3122,613,leisure,1050,1110,60
3123,613,home,1110,1440,330
3124,614,home,0,375,375
3125,614,shop,375,405,30
3126,614,work,405,990,585
3127,614,education,990,1080,90
3128,614,home,1080,1245,165
3129,614,leisure,1245,1260,15
3130,614,home,1260,1440,180
3131,615,home,0,390,390
3132,615,shop,390,420,30
3133,615,work,420,825,405
3134,615,education,825,990,165
3135,615,home,990,1440,450
3136,616,home,0,390,390
3137,616,shop,390,420,30
3138,616,work,420,1005,585
3139,616,leisure,1005,1080,75
3140,616,home,1080,1440,360
3141,617,home,0,390,390
3142,617,shop,390,420,30
3143,617,work,420,930,510
3144,617,leisure,930,990,60
3145,617,home,990,1440,450
3146,618,home,0,375,375
3147,618,work,375,810,435
3148,618,education,810,960,150
3149,618,leisure,960,1050,90
3150,618,home,1050,1440,390
3151,619,home,0,375,375
3152,619,shop,375,405,30
3153,619,work,405,915,510
3154,619,leisure,915,990,75
3155,619,home,990,1440,450
3156,620,home,0,405,405
3157,620,shop,405,435,30
3158,620,work,435,1035,600
3159,620,education,1035,1080,45
3160,620,home,1080,1440,360
3161,621,home,0,405,405
3162,621,leisure,405,420,15
3163,621,work,420,900,480
3164,621,shop,900,960,60
3165,621,home,960,1140,180
3166,621,leisure,1140,1200,60
3167,621,home,1200,1440,240
3168,622,home,0,405,405
3169,622,shop,405,435,30
3170,622,work,435,870,435
3171,622,shop,870,960,90
3172,622,home,960,1440,480
3173,623,home,0,405,405
3174,623,shop,405,465,60
3175,623,work,465,975,510
3176,623,education,975,1080,105
3177,623,home,1080,1440,360
3178,624,home,0,390,390
3179,624,shop,390,450,60
3180,624,work,450,1005,555
3181,624,leisure,1005,1035,30
3182,624,home,1035,1440,405
3183,625,home,0,390,390
3184,625,shop,390,420,30
3185,625,work,420,1005,585
3186,625,education,1005,1080,75
3187,625,home,1080,1440,360
3188,626,home,0,375,375
3189,626,work,375,825,450
3190,626,education,825,975,150
3191,626,home,975,1440,465
3192,627,home,0,375,375
3193,627,work,375,825,450
3194,627,education,825,1020,195
3195,627,home,1020,1440,420
3196,628,home,0,375,375
3197,628,shop,375,390,15
3198,628,work,390,810,420
3199,628,education,810,990,180
3200,628,home,990,1440,450
3201,629,home,0,390,390
3202,629,work,390,885,495
3203,629,home,885,1125,240
3204,629,leisure,1125,1215,90
3205,629,home,1215,1440,225
3206,630,home,0,375,375
3207,630,leisure,375,435,60
3208,630,work,435,930,495
3209,630,shop,930,960,30
3210,630,home,960,1440,480
3211,631,home,0,375,375
3212,631,leisure,375,390,15
3213,631,work,390,825,435
3214,631,education,825,1020,195
3215,631,home,1020,1440,420
3216,632,home,0,390,390
3217,632,leisure,390,435,45
3218,632,work,435,990,555
3219,632,shop,990,1005,15
3220,632,home,1005,1440,435
3221,633,home,0,390,390
3222,633,work,390,825,435
3223,633,education,825,975,150
3224,633,shop,975,990,15
3225,633,home,990,1440,450
3226,634,home,0,390,390
3227,634,shop,390,405,15
3228,634,education,405,525,120
3229,634,work,525,990,465
3230,634,leisure,990,1050,60
3231,634,home,1050,1440,390
3232,635,home,0,390,390
3233,635,shop,390,435,45
3234,635,work,435,960,525
3235,635,leisure,960,1020,60
3236,635,home,1020,1440,420
3237,636,home,0,375,375
3238,636,shop,375,390,15
3239,636,leisure,390,450,60
3240,636,work,450,885,435
3241,636,home,885,1035,150
3242,636,shop,1035,1050,15
3243,636,home,1050,1440,390
3244,637,home,0,390,390
3245,637,shop,390,450,60
3246,637,work,450,975,525
3247,637,leisure,975,1035,60
3248,637,home,1035,1440,405
3249,638,home,0,390,390
3250,638,work,390,960,570
3251,638,shop,960,975,15
3252,638,home,975,1440,465
3253,639,home,0,390,390
3254,639,work,390,750,360
3255,639,education,750,1050,300
3256,639,home,1050,1440,390
3257,640,home,0,375,375
3258,640,shop,375,420,45
3259,640,work,420,975,555
3260,640,leisure,975,1035,60
3261,640,home,1035,1440,405
3262,641,home,0,375,375
3263,641,shop,375,435,60
3264,641,education,435,495,60
3265,641,work,495,975,480
3266,641,leisure,975,1050,75
3267,641,home,1050,1440,390
3268,642,home,0,390,390
3269,642,work,390,960,570
3270,642,shop,960,975,15
3271,642,home,975,1440,465
3272,643,home,0,375,375
3273,643,shop,375,405,30
3274,643,work,405,825,420
3275,643,education,825,975,150
3276,643,home,975,1440,465
3277,644,home,0,375,375
3278,644,leisure,375,435,60
3279,644,work,435,975,540
3280,644,education,975,1080,105
3281,644,home,1080,1440,360
3282,645,home,0,420,420
3283,645,leisure,420,480,60
3284,645,work,480,1035,555
3285,645,education,1035,1080,45
3286,645,home,1080,1440,360
3287,646,home,0,375,375
3288,646,shop,375,390,15
3289,646,work,390,945,555
3290,646,home,945,1170,225
3291,646,shop,1170,1185,15
3292,646,home,1185,1440,255
3293,647,home,0,375,375
3294,647,leisure,375,435,60
3295,647,work,435,975,540
3296,647,education,975,1080,105
3297,647,home,1080,1440,360
3298,648,home,0,375,375
3299,648,shop,375,435,60
3300,648,work,435,975,540
3301,648,leisure,975,1035,60
3302,648,home,1035,1440,405
3303,649,home,0,405,405
3304,649,work,405,915,510
3305,649,shop,915,960,45
3306,649,home,960,1140,180
3307,649,leisure,1140,1200,60
3308,649,home,1200,1440,240
3309,650,home,0,390,390
3310,650,shop,390,405,15
3311,650,work,405,825,420
3312,650,education,825,945,120
3313,650,shop,945,960,15
3314,650,home,960,1440,480
3315,651,home,0,405,405
3316,651,shop,405,450,45
3317,651,work,450,990,540
3318,651,leisure,990,1140,150
3319,651,home,1140,1440,300
3320,652,home,0,375,375
3321,652,work,375,810,435
3322,652,education,810,1005,195
3323,652,home,1005,1440,435
3324,653,home,0,390,390
3325,653,leisure,390,420,30
3326,653,work,420,930,510
3327,653,leisure,930,1050,120
3328,653,home,1050,1440,390
3329,654,home,0,390,390
3330,654,work,390,960,570
3331,654,leisure,960,1080,120
3332,654,home,1080,1440,360
3333,655,home,0,390,390
3334,655,shop,390,450,60
3335,655,education,450,480,30
3336,655,work,480,975,495
3337,655,leisure,975,1080,105
3338,655,home,1080,1440,360
3339,656,home,0,375,375
3340,656,shop,375,405,30
3341,656,work,405,885,480
3342,656,shop,885,960,75
3343,656,home,960,1440,480
3344,657,home,0,375,375
3345,657,work,375,795,420
3346,657,education,795,930,135
3347,657,shop,930,960,30
3348,657,home,960,1440,480
3349,658,home,0,375,375
3350,658,work,375,1005,630
3351,658,education,1005,1050,45
3352,658,home,1050,1440,390
3353,659,home,0,390,390
3354,659,work,390,795,405
3355,659,education,795,960,165
3356,659,leisure,960,1020,60
3357,659,home,1020,1440,420
3358,660,home,0,375,375
3359,660,shop,375,405,30
3360,660,work,405,960,555
3361,660,shop,960,975,15
3362,660,home,975,1215,240
3363,660,leisure,1215,1290,75
3364,660,home,1290,1440,150
3365,661,home,0,375,375
3366,661,leisure,375,435,60
3367,661,work,435,855,420
3368,661,shop,855,915,60
3369,661,home,915,1440,525
3370,662,home,0,390,390
3371,662,leisure,390,435,45
3372,662,work,435,960,525
3373,662,shop,960,975,15
3374,662,home,975,1440,465
3375,663,home,0,375,375
3376,663,shop,375,390,15
3377,663,work,390,960,570
3378,663,leisure,960,1005,45
3379,663,home,1005,1440,435
3380,664,home,0,375,375
3381,664,leisure,375,405,30
3382,664,work,405,1005,600
3383,664,education,1005,1080,75
3384,664,home,1080,1440,360
3385,665,home,0,405,405
3386,665,leisure,405,435,30
3387,665,work,435,1005,570
3388,665,shop,1005,1020,15
3389,665,home,1020,1440,420
3390,666,home,0,390,390
3391,666,leisure,390,465,75
3392,666,work,465,1005,540
3393,666,education,1005,1080,75
3394,666,home,1080,1440,360
3395,667,home,0,375,375
3396,667,shop,375,420,45
3397,667,work,420,960,540
3398,667,leisure,960,1050,90
3399,667,home,1050,1440,390
3400,668,home,0,390,390
3401,668,leisure,390,435,45
3402,668,work,435,975,540
3403,668,shop,975,990,15
3404,668,home,990,1440,450
3405,669,home,0,390,390
3406,669,shop,390,435,45
3407,669,work,435,1005,570
3408,669,education,1005,1080,75
3409,669,home,1080,1440,360
3410,670,home,0,375,375
3411,670,work,375,825,450
3412,670,shop,825,885,60
3413,670,leisure,885,990,105
3414,670,home,990,1440,450
3415,671,home,0,390,390
3416,671,leisure,390,420,30
3417,671,work,420,960,540
3418,671,home,960,1140,180
3419,671,shop,1140,1155,15
3420,671,home,1155,1440,285
3421,672,home,0,390,390
3422,672,leisure,390,405,15
3423,672,work,405,990,585
3424,672,education,990,1080,90
3425,672,home,1080,1440,360
3426,673,home,0,390,390
3427,673,work,390,810,420
3428,673,education,810,1020,210
3429,673,home,1020,1440,420
3430,674,home,0,390,390
3431,674,leisure,390,420,30
3432,674,work,420,945,525
3433,674,shop,945,960,15
3434,674,home,960,1440,480
3435,675,home,0,420,420
3436,675,shop,420,465,45
3437,675,work,465,960,495
3438,675,shop,960,975,15
3439,675,home,975,1440,465
3440,676,home,0,405,405
3441,676,shop,405,435,30
3442,676,work,435,975,540
3443,676,education,975,1080,105
3444,676,home,1080,1440,360
3445,677,home,0,375,375
3446,677,shop,375,405,30
3447,677,work,405,990,585
3448,677,leisure,990,1050,60
3449,677,home,1050,1440,390
3450,678,home,0,375,375
3451,678,shop,375,420,45
3452,678,work,420,975,555
3453,678,education,975,1080,105
3454,678,home,1080,1440,360
3455,679,home,0,405,405
3456,679,leisure,405,420,15
3457,679,work,420,975,555
3458,679,education,975,1080,105
3459,679,home,1080,1440,360
3460,680,home,0,390,390
3461,680,shop,390,405,15
3462,680,work,405,975,570
3463,680,shop,975,990,15
3464,680,home,990,1440,450
3465,681,home,0,390,390
3466,681,shop,390,450,60
3467,681,work,450,945,495
3468,681,leisure,945,1005,60
3469,681,home,1005,1440,435
3470,682,home,0,390,390
3471,682,work,390,810,420
3472,682,education,810,930,120
3473,682,leisure,930,990,60
3474,682,home,990,1440,450
3475,683,home,0,375,375
3476,683,work,375,795,420
3477,683,education,795,1005,210
3478,683,leisure,1005,1065,60
3479,683,home,1065,1440,375
3480,684,home,0,390,390
3481,684,work,390,1005,615
3482,684,education,1005,1080,75
3483,684,home,1080,1440,360
3484,685,home,0,390,390
3485,685,shop,390,405,15
3486,685,work,405,825,420
3487,685,education,825,975,150
3488,685,shop,975,990,15
3489,685,home,990,1440,450
3490,686,home,0,375,375
3491,686,work,375,975,600
3492,686,leisure,975,1080,105
3493,686,home,1080,1440,360
3494,687,home,0,390,390
3495,687,work,390,810,420
3496,687,shop,810,945,135
3497,687,home,945,1185,240
3498,687,leisure,1185,1200,15
3499,687,work,1200,1215,15
3500,687,home,1215,1440,225
3501,688,home,0,375,375
3502,688,shop,375,390,15
3503,688,work,390,930,540
3504,688,shop,930,960,30
3505,688,home,960,1440,480
3506,689,home,0,375,375
3507,689,shop,375,435,60
3508,689,work,435,945,510
3509,689,leisure,945,1005,60
3510,689,home,1005,1440,435
3511,690,home,0,375,375
3512,690,work,375,810,435
3513,690,shop,810,960,150
3514,690,home,960,1440,480
3515,691,home,0,375,375
3516,691,work,375,795,420
3517,691,education,795,975,180
3518,691,home,975,1245,270
3519,691,leisure,1245,1305,60
3520,691,home,1305,1440,135
3521,692,home,0,390,390
3522,692,shop,390,420,30
3523,692,work,420,945,525
3524,692,leisure,945,1005,60
3525,692,home,1005,1440,435
3526,693,home,0,375,375
3527,693,work,375,915,540
3528,693,leisure,915,990,75
3529,693,home,990,1440,450
3530,694,home,0,405,405
3531,694,shop,405,435,30
3532,694,work,435,960,525
3533,694,leisure,960,1020,60
3534,694,home,1020,1440,420
3535,695,home,0,420,420
3536,695,shop,420,465,45
3537,695,work,465,945,480
3538,695,leisure,945,1020,75
3539,695,home,1020,1440,420
3540,696,home,0,375,375
3541,696,shop,375,390,15
3542,696,leisure,390,405,15
3543,696,work,405,945,540
3544,696,leisure,945,1035,90
3545,696,home,1035,1440,405
3546,697,home,0,390,390
3547,697,work,390,810,420
3548,697,education,810,1005,195
3549,697,home,1005,1440,435
3550,698,home,0,405,405
3551,698,work,405,975,570
3552,698,shop,975,990,15
3553,698,home,990,1440,450
3554,699,home,0,405,405
3555,699,work,405,945,540
3556,699,leisure,945,1005,60
3557,699,home,1005,1440,435
3558,700,home,0,375,375
3559,700,work,375,990,615
3560,700,education,990,1080,90
3561,700,home,1080,1440,360
3562,701,home,0,375,375
3563,701,shop,375,405,30
3564,701,work,405,825,420
3565,701,education,825,945,120
3566,701,shop,945,960,15
3567,701,home,960,1440,480
3568,702,home,0,375,375
3569,702,shop,375,420,45
3570,702,work,420,1005,585
3571,702,home,1005,1440,435
3572,703,home,0,390,390
3573,703,work,390,990,600
3574,703,education,990,1080,90
3575,703,home,1080,1440,360
3576,704,home,0,405,405
3577,704,shop,405,450,45
3578,704,work,450,915,465
3579,704,home,915,1110,195
3580,704,leisure,1110,1185,75
3581,704,home,1185,1440,255
3582,705,home,0,405,405
3583,705,work,405,930,525
3584,705,leisure,930,975,45
3585,705,home,975,1440,465
3586,706,home,0,375,375
3587,706,shop,375,390,15
3588,706,education,390,450,60
3589,706,work,450,990,540
3590,706,leisure,990,1050,60
3591,706,home,1050,1440,390
3592,707,home,0,375,375
3593,707,work,375,795,420
3594,707,education,795,930,135
3595,707,leisure,930,990,60
3596,707,home,990,1440,450
3597,708,home,0,420,420
3598,708,work,420,975,555
3599,708,leisure,975,1035,60
3600,708,home,1035,1440,405
3601,709,home,0,375,375
3602,709,shop,375,435,60
3603,709,work,435,945,510
3604,709,leisure,945,1020,75
3605,709,home,1020,1440,420
3606,710,home,0,375,375
3607,710,shop,375,420,45
3608,710,education,420,495,75
3609,710,work,495,1080,585
3610,710,leisure,1080,1125,45
3611,710,home,1125,1440,315
3612,711,home,0,375,375
3613,711,shop,375,390,15
3614,711,work,390,810,420
3615,711,education,810,1020,210
3616,711,home,1020,1440,420
3617,712,home,0,390,390
3618,712,work,390,810,420
3619,712,shop,810,945,135
3620,712,home,945,1005,60
3621,712,leisure,1005,1050,45
3622,712,home,1050,1440,390
3623,713,home,0,375,375
3624,713,shop,375,405,30
3625,713,work,405,960,555
3626,713,leisure,960,1050,90
3627,713,home,1050,1440,390
3628,714,home,0,375,375
3629,714,work,375,795,420
3630,714,education,795,960,165
3631,714,leisure,960,1035,75
3632,714,home,1035,1440,405
3633,715,home,0,375,375
3634,715,shop,375,390,15
3635,715,work,390,780,390
3636,715,education,780,885,105
3637,715,leisure,885,990,105
3638,715,home,990,1440,450
3639,716,home,0,405,405
3640,716,shop,405,435,30
3641,716,work,435,960,525
3642,716,leisure,960,1020,60
3643,716,home,1020,1440,420
3644,717,home,0,375,375
3645,717,shop,375,420,45
3646,717,work,420,945,525
3647,717,shop,945,960,15
3648,717,home,960,1440,480
3649,718,home,0,390,390
3650,718,work,390,945,555
3651,718,shop,945,960,15
3652,718,home,960,1440,480
3653,719,home,0,390,390
3654,719,shop,390,465,75
3655,719,work,465,960,495
3656,719,leisure,960,1035,75
3657,719,home,1035,1440,405
3658,720,home,0,405,405
3659,720,work,405,975,570
3660,720,leisure,975,1035,60
3661,720,home,1035,1440,405
3662,721,home,0,375,375
3663,721,shop,375,420,45
3664,721,leisure,420,480,60
3665,721,work,480,1005,525
3666,721,education,1005,1080,75
3667,721,home,1080,1440,360
3668,722,home,0,390,390
3669,722,work,390,810,420
3670,722,education,810,990,180
3671,722,shop,990,1005,15
3672,722,home,1005,1440,435
3673,723,home,0,390,390
3674,723,shop,390,450,60
3675,723,work,450,960,510
3676,723,leisure,960,1035,75
3677,723,home,1035,1440,405
3678,724,home,0,375,375
3679,724,leisure,375,405,30
3680,724,work,405,945,540
3681,724,leisure,945,990,45
3682,724,home,990,1440,450
3683,725,home,0,375,375
3684,725,leisure,375,390,15
3685,725,work,390,885,495
3686,725,shop,885,960,75
3687,725,home,960,1260,300
3688,725,leisure,1260,1320,60
3689,725,home,1320,1440,120
3690,726,home,0,375,375
3691,726,work,375,930,555
3692,726,leisure,930,990,60
3693,726,home,990,1440,450
3694,727,home,0,375,375
3695,727,work,375,990,615
3696,727,leisure,990,1050,60
3697,727,home,1050,1440,390
3698,728,home,0,390,390
3699,728,work,390,810,420
3700,728,education,810,990,180
3701,728,shop,990,1005,15
3702,728,home,1005,1260,255
3703,728,leisure,1260,1320,60
3704,728,home,1320,1440,120
3705,729,home,0,390,390
3706,729,shop,390,420,30
3707,729,work,420,990,570
3708,729,leisure,990,1050,60
3709,729,home,1050,1440,390
3710,730,home,0,390,390
3711,730,leisure,390,435,45
3712,730,work,435,900,465
3713,730,shop,900,960,60
3714,730,home,960,1440,480
3715,731,home,0,375,375
3716,731,work,375,795,420
3717,731,education,795,915,120
3718,731,shop,915,960,45
3719,731,home,960,1140,180
3720,731,shop,1140,1155,15
3721,731,home,1155,1440,285
3722,732,home,0,390,390
3723,732,shop,390,405,15
3724,732,work,405,870,465
3725,732,shop,870,960,90
3726,732,home,960,1440,480
3727,733,home,0,390,390
3728,733,shop,390,450,60
3729,733,work,450,990,540
3730,733,leisure,990,1050,60
3731,733,home,1050,1440,390
3732,734,home,0,390,390
3733,734,shop,390,420,30
3734,734,work,420,945,525
3735,734,leisure,945,1020,75
3736,734,home,1020,1440,420
3737,735,home,0,375,375
3738,735,shop,375,405,30
3739,735,work,405,915,510
3740,735,shop,915,960,45
3741,735,home,960,1140,180
3742,735,shop,1140,1155,15
3743,735,home,1155,1230,75
3744,735,leisure,1230,1245,15
3745,735,home,1245,1440,195
3746,736,home,0,405,405
3747,736,shop,405,465,60
3748,736,work,465,990,525
3749,736,leisure,990,1020,30
3750,736,home,1020,1440,420
3751,737,home,0,375,375
3752,737,work,375,975,600
3753,737,education,975,1065,90
3754,737,home,1065,1440,375
3755,738,home,0,390,390
3756,738,shop,390,420,30
3757,738,work,420,1005,585
3758,738,leisure,1005,1065,60
3759,738,home,1065,1440,375
3760,739,home,0,375,375
3761,739,work,375,795,420
3762,739,education,795,990,195
3763,739,home,990,1215,225
3764,739,leisure,1215,1275,60
3765,739,shop,1275,1290,15
3766,739,home,1290,1440,150
3767,740,home,0,390,390
3768,740,work,390,945,555
3769,740,leisure,945,1005,60
3770,740,home,1005,1440,435
3771,741,home,0,405,405
3772,741,shop,405,450,45
3773,741,work,450,990,540
3774,741,leisure,990,1050,60
3775,741,home,1050,1440,390
3776,742,home,0,390,390
3777,742,shop,390,405,15
3778,742,work,405,750,345
3779,742,education,750,870,120
3780,742,shop,870,960,90
3781,742,home,960,1440,480
3782,743,home,0,375,375
3783,743,shop,375,420,45
3784,743,work,420,960,540
3785,743,leisure,960,1020,60
3786,743,home,1020,1440,420
3787,744,home,0,375,375
3788,744,leisure,375,420,45
3789,744,work,420,975,555
3790,744,shop,975,990,15
3791,744,home,990,1035,45
3792,744,leisure,1035,1065,30
3793,744,home,1065,1440,375
3794,745,home,0,375,375
3795,745,leisure,375,405,30
3796,745,work,405,825,420
3797,745,shop,825,960,135
3798,745,home,960,1440,480
3799,746,home,0,375,375
3800,746,shop,375,405,30
3801,746,work,405,915,510
3802,746,home,915,1155,240
3803,746,leisure,1155,1245,90
3804,746,home,1245,1440,195
3805,747,home,0,375,375
3806,747,shop,375,435,60
3807,747,work,435,990,555
3808,747,leisure,990,1050,60
3809,747,home,1050,1440,390
3810,748,home,0,390,390
3811,748,shop,390,435,45
3812,748,work,435,960,525
3813,748,leisure,960,1020,60
3814,748,home,1020,1440,420
3815,749,home,0,375,375
3816,749,work,375,795,420
3817,749,shop,795,885,90
3818,749,home,885,1440,555
3819,750,home,0,435,435
3820,750,work,435,1005,570
3821,750,education,1005,1080,75
3822,750,home,1080,1440,360
3823,751,home,0,375,375
3824,751,leisure,375,435,60
3825,751,work,435,990,555
3826,751,shop,990,1005,15
3827,751,home,1005,1440,435
3828,752,home,0,390,390
3829,752,shop,390,450,60
3830,752,work,450,930,480
3831,752,leisure,930,1020,90
3832,752,home,1020,1440,420
3833,753,home,0,405,405
3834,753,shop,405,465,60
3835,753,work,465,975,510
3836,753,leisure,975,1035,60
3837,753,home,1035,1440,405
3838,754,home,0,390,390
3839,754,shop,390,420,30
3840,754,work,420,945,525
3841,754,leisure,945,1050,105
3842,754,home,1050,1440,390
3843,755,home,0,390,390
3844,755,shop,390,435,45
3845,755,education,435,555,120
3846,755,work,555,1005,450
3847,755,leisure,1005,1065,60
3848,755,home,1065,1440,375
3849,756,home,0,375,375
3850,756,work,375,930,555
3851,756,leisure,930,1005,75
3852,756,home,1005,1440,435
3853,757,home,0,375,375
3854,757,work,375,795,420
3855,757,education,795,990,195
3856,757,home,990,1440,450
3857,758,home,0,375,375
3858,758,shop,375,420,45
3859,758,work,420,885,465
3860,758,shop,885,960,75
3861,758,home,960,1275,315
3862,758,leisure,1275,1305,30
3863,758,home,1305,1440,135
3864,759,home,0,390,390
3865,759,work,390,975,585
3866,759,education,975,1080,105
3867,759,home,1080,1440,360
3868,760,home,0,390,390
3869,760,shop,390,405,15
3870,760,work,405,975,570
3871,760,leisure,975,1035,60
3872,760,shop,1035,1050,15
3873,760,home,1050,1440,390
3874,761,home,0,375,375
3875,761,work,375,975,600
3876,761,shop,975,990,15
3877,761,home,990,1440,450
3878,762,home,0,390,390
3879,762,shop,390,405,15
3880,762,work,405,990,585
3881,762,education,990,1080,90
3882,762,home,1080,1440,360
3883,763,home,0,405,405
3884,763,shop,405,465,60
3885,763,work,465,975,510
3886,763,education,975,1080,105
3887,763,home,1080,1440,360
3888,764,home,0,390,390
3889,764,work,390,975,585
3890,764,home,975,1110,135
3891,764,leisure,1110,1125,15
3892,764,home,1125,1440,315
3893,765,home,0,375,375
3894,765,shop,375,435,60
3895,765,work,435,930,495
3896,765,leisure,930,1005,75
3897,765,home,1005,1440,435
3898,766,home,0,375,375
3899,766,shop,375,420,45
3900,766,work,420,960,540
3901,766,shop,960,975,15
3902,766,home,975,1440,465
3903,767,home,0,375,375
3904,767,shop,375,450,75
3905,767,work,450,990,540
3906,767,education,990,1080,90
3907,767,home,1080,1440,360
3908,768,home,0,390,390
3909,768,shop,390,420,30
3910,768,work,420,945,525
3911,768,leisure,945,1005,60
3912,768,shop,1005,1020,15
3913,768,home,1020,1440,420
3914,769,home,0,390,390
3915,769,shop,390,405,15
3916,769,work,405,945,540
3917,769,leisure,945,1005,60
3918,769,home,1005,1440,435
3919,770,home,0,375,375
3920,770,work,375,870,495
3921,770,shop,870,945,75
3922,770,home,945,1440,495
3923,771,home,0,390,390
3924,771,shop,390,420,30
3925,771,work,420,945,525
3926,771,shop,945,960,15
3927,771,home,960,1140,180
3928,771,leisure,1140,1200,60
3929,771,home,1200,1440,240
3930,772,home,0,375,375
3931,772,shop,375,435,60
3932,772,education,435,555,120
3933,772,work,555,1005,450
3934,772,leisure,1005,1020,15
3935,772,home,1020,1440,420
3936,773,home,0,435,435
3937,773,work,435,990,555
3938,773,education,990,1080,90
3939,773,home,1080,1440,360
3940,774,home,0,375,375
3941,774,work,375,795,420
3942,774,education,795,975,180
3943,774,leisure,975,1080,105
3944,774,home,1080,1440,360
3945,775,home,0,390,390
3946,775,leisure,390,405,15
3947,775,work,405,825,420
3948,775,education,825,1005,180
3949,775,home,1005,1440,435
3950,776,home,0,375,375
3951,776,shop,375,390,15
3952,776,work,390,915,525
3953,776,shop,915,960,45
3954,776,home,960,1440,480
3955,777,home,0,405,405
3956,777,work,405,1005,600
3957,777,leisure,1005,1065,60
3958,777,home,1065,1440,375
3959,778,home,0,375,375
3960,778,shop,375,435,60
3961,778,work,435,990,555
3962,778,leisure,990,1035,45
3963,778,home,1035,1440,405
3964,779,home,0,405,405
3965,779,shop,405,450,45
3966,779,work,450,945,495
3967,779,leisure,945,1065,120
3968,779,home,1065,1440,375
3969,780,home,0,390,390
3970,780,shop,390,435,45
3971,780,work,435,960,525
3972,780,leisure,960,1035,75
3973,780,home,1035,1440,405
3974,781,home,0,375,375
3975,781,shop,375,420,45
3976,781,work,420,1005,585
3977,781,shop,1005,1020,15
3978,781,home,1020,1440,420
3979,782,home,0,375,375
3980,782,shop,375,420,45
3981,782,work,420,1005,585
3982,782,home,1005,1440,435
3983,783,home,0,390,390
3984,783,shop,390,405,15
3985,783,work,405,825,420
3986,783,shop,825,930,105
3987,783,home,930,1440,510
3988,784,home,0,375,375
3989,784,shop,375,390,15
3990,784,leisure,390,420,30
3991,784,work,420,990,570
3992,784,home,990,1185,195
3993,784,shop,1185,1200,15
3994,784,home,1200,1440,240
3995,785,home,0,405,405
3996,785,shop,405,420,15
3997,785,work,420,990,570
3998,785,education,990,1080,90
3999,785,home,1080,1440,360
4000,786,home,0,390,390
4001,786,work,390,810,420
4002,786,home,810,945,135
4003,786,shop,945,960,15
4004,786,home,960,1170,210
4005,786,leisure,1170,1230,60
4006,786,home,1230,1440,210
4007,787,home,0,375,375
4008,787,shop,375,435,60
4009,787,education,435,540,105
4010,787,work,540,1005,465
4011,787,leisure,1005,1080,75
4012,787,home,1080,1440,360
4013,788,home,0,390,390
4014,788,leisure,390,450,60
4015,788,work,450,975,525
4016,788,education,975,1080,105
4017,788,home,1080,1440,360
4018,789,home,0,390,390
4019,789,work,390,780,390
4020,789,education,780,930,150
4021,789,shop,930,960,30
4022,789,home,960,1440,480
4023,790,home,0,405,405
4024,790,leisure,405,420,15
4025,790,work,420,900,480
4026,790,shop,900,960,60
4027,790,home,960,1440,480
4028,791,home,0,375,375
4029,791,leisure,375,420,45
4030,791,work,420,930,510
4031,791,shop,930,960,30
4032,791,home,960,1440,480
4033,792,home,0,390,390
4034,792,shop,390,435,45
4035,792,work,435,975,540
4036,792,leisure,975,1095,120
4037,792,home,1095,1440,345
4038,793,home,0,390,390
4039,793,leisure,390,420,30
4040,793,work,420,1020,600
4041,793,education,1020,1080,60
4042,793,home,1080,1440,360
4043,794,home,0,375,375
4044,794,work,375,780,405
4045,794,education,780,1020,240
4046,794,home,1020,1440,420
4047,795,home,0,375,375
4048,795,work,375,810,435
4049,795,home,810,1125,315
4050,795,shop,1125,1140,15
4051,795,home,1140,1440,300
4052,796,home,0,390,390
4053,796,work,390,945,555
4054,796,leisure,945,990,45
4055,796,home,990,1440,450
4056,797,home,0,375,375
4057,797,work,375,810,435
4058,797,education,810,1005,195
4059,797,home,1005,1440,435
4060,798,home,0,405,405
4061,798,shop,405,480,75
4062,798,work,480,975,495
4063,798,education,975,1080,105
4064,798,home,1080,1440,360
4065,799,home,0,375,375
4066,799,work,375,795,420
4067,799,education,795,930,135
4068,799,shop,930,960,30
4069,799,home,960,1440,480
4070,800,home,0,390,390
4071,800,leisure,390,405,15
4072,800,work,405,840,435
4073,800,home,840,1020,180
4074,800,leisure,1020,1080,60
4075,800,home,1080,1440,360
4076,801,home,0,375,375
4077,801,leisure,375,390,15
4078,801,work,390,1005,615
4079,801,shop,1005,1020,15
4080,801,home,1020,1440,420
4081,802,home,0,405,405
4082,802,shop,405,420,15
4083,802,work,420,990,570
4084,802,leisure,990,1020,30
4085,802,home,1020,1245,225
4086,802,leisure,1245,1305,60
4087,802,home,1305,1440,135
4088,803,home,0,375,375
4089,803,shop,375,435,60
4090,803,work,435,960,525
4091,803,leisure,960,1035,75
4092,803,home,1035,1440,405
4093,804,home,0,405,405
4094,804,shop,405,420,15
4095,804,work,420,900,480
4096,804,home,900,1110,210
4097,804,leisure,1110,1200,90
4098,804,home,1200,1440,240
4099,805,home,0,375,375
4100,805,shop,375,420,45
4101,805,work,420,975,555
4102,805,leisure,975,1050,75
4103,805,home,1050,1440,390
4104,806,home,0,375,375
4105,806,leisure,375,390,15
4106,806,work,390,825,435
4107,806,shop,825,960,135
4108,806,home,960,1440,480
4109,807,home,0,390,390
4110,807,work,390,900,510
4111,807,shop,900,960,60
4112,807,home,960,1440,480
4113,808,home,0,390,390
4114,808,shop,390,450,60
4115,808,work,450,930,480
4116,808,leisure,930,990,60
4117,808,home,990,1440,450
4118,809,home,0,375,375
4119,809,shop,375,390,15
4120,809,work,390,870,480
4121,809,shop,870,960,90
4122,809,home,960,1155,195
4123,809,education,1155,1170,15
4124,809,home,1170,1440,270
4125,810,home,0,390,390
4126,810,leisure,390,435,45
4127,810,work,435,975,540
4128,810,shop,975,990,15
4129,810,home,990,1440,450
4130,811,home,0,375,375
4131,811,shop,375,450,75
4132,811,work,450,930,480
4133,811,home,930,1440,510
4134,812,home,0,375,375
4135,812,work,375,795,420
4136,812,education,795,975,180
4137,812,home,975,1185,210
4138,812,leisure,1185,1230,45
4139,812,home,1230,1440,210
4140,813,home,0,375,375
4141,813,work,375,795,420
4142,813,education,795,975,180
4143,813,home,975,1440,465
4144,814,home,0,390,390
4145,814,work,390,810,420
4146,814,education,810,1020,210
4147,814,home,1020,1440,420
4148,815,home,0,375,375
4149,815,shop,375,405,30
4150,815,work,405,975,570
4151,815,leisure,975,1035,60
4152,815,home,1035,1440,405
4153,816,home,0,375,375
4154,816,leisure,375,405,30
4155,816,work,405,990,585
4156,816,education,990,1080,90
4157,816,home,1080,1440,360
4158,817,home,0,375,375
4159,817,leisure,375,390,15
4160,817,work,390,960,570
4161,817,leisure,960,1020,60
4162,817,home,1020,1440,420
4163,818,home,0,420,420
4164,818,leisure,420,465,45
4165,818,work,465,1005,540
4166,818,shop,1005,1020,15
4167,818,home,1020,1440,420
4168,819,home,0,390,390
4169,819,shop,390,435,45
4170,819,work,435,915,480
4171,819,shop,915,960,45
4172,819,home,960,1440,480
4173,820,home,0,375,375
4174,820,work,375,990,615
4175,820,shop,990,1005,15
4176,820,home,1005,1440,435
4177,821,home,0,375,375
4178,821,shop,375,390,15
4179,821,work,390,1005,615
4180,821,education,1005,1080,75
4181,821,home,1080,1440,360
4182,822,home,0,390,390
4183,822,work,390,915,525
4184,822,leisure,915,975,60
4185,822,shop,975,990,15
4186,822,home,990,1440,450
4187,823,home,0,405,405
4188,823,work,405,915,510
4189,823,shop,915,930,15
4190,823,home,930,1200,270
4191,823,leisure,1200,1260,60
4192,823,home,1260,1440,180
4193,824,home,0,375,375
4194,824,leisure,375,435,60
4195,824,work,435,990,555
4196,824,education,990,1080,90
4197,824,home,1080,1440,360
4198,825,home,0,390,390
4199,825,leisure,390,450,60
4200,825,work,450,945,495
4201,825,shop,945,960,15
4202,825,home,960,1440,480
4203,826,home,0,375,375
4204,826,work,375,810,435
4205,826,education,810,960,150
4206,826,leisure,960,1035,75
4207,826,home,1035,1080,45
4208,826,shop,1080,1095,15
4209,826,home,1095,1440,345
4210,827,home,0,405,405
4211,827,work,405,825,420
4212,827,home,825,1005,180
4213,827,leisure,1005,1050,45
4214,827,home,1050,1440,390
4215,828,home,0,375,375
4216,828,shop,375,405,30
4217,828,education,405,525,120
4218,828,work,525,975,450
4219,828,leisure,975,1065,90
4220,828,home,1065,1440,375
4221,829,home,0,375,375
4222,829,shop,375,405,30
4223,829,work,405,825,420
4224,829,education,825,945,120
4225,829,leisure,945,1020,75
4226,829,home,1020,1440,420
4227,830,home,0,375,375
4228,830,leisure,375,435,60
4229,830,work,435,990,555
4230,830,education,990,1080,90
4231,830,home,1080,1440,360
4232,831,home,0,390,390
4233,831,shop,390,435,45
4234,831,work,435,960,525
4235,831,leisure,960,1020,60
4236,831,home,1020,1440,420
4237,832,home,0,390,390
4238,832,shop,390,465,75
4239,832,work,465,1005,540
4240,832,education,1005,1080,75
4241,832,home,1080,1440,360
4242,833,home,0,405,405
4243,833,leisure,405,450,45
4244,833,work,450,930,480
4245,833,shop,930,960,30
4246,833,home,960,1440,480
4247,834,home,0,390,390
4248,834,work,390,810,420
4249,834,education,810,930,120
4250,834,shop,930,960,30
4251,834,home,960,1215,255
4252,834,leisure,1215,1275,60
4253,834,home,1275,1440,165
4254,835,home,0,375,375
4255,835,work,375,960,585
4256,835,leisure,960,1020,60
4257,835,home,1020,1440,420
4258,836,home,0,375,375
4259,836,shop,375,390,15
4260,836,work,390,990,600
4261,836,education,990,1080,90
4262,836,home,1080,1440,360
4263,837,home,0,375,375
4264,837,shop,375,435,60
4265,837,education,435,555,120
4266,837,work,555,1020,465
4267,837,leisure,1020,1110,90
4268,837,home,1110,1440,330
4269,838,home,0,375,375
4270,838,work,375,975,600
4271,838,shop,975,990,15
4272,838,home,990,1170,180
4273,838,shop,1170,1185,15
4274,838,home,1185,1440,255
4275,839,home,0,375,375
4276,839,shop,375,420,45
4277,839,work,420,915,495
4278,839,leisure,915,1035,120
4279,839,home,1035,1440,405
4280,840,home,0,390,390
4281,840,shop,390,405,15
4282,840,education,405,510,105
4283,840,work,510,930,420
4284,840,leisure,930,1005,75
4285,840,shop,1005,1020,15
4286,840,home,1020,1440,420
4287,841,home,0,390,390
4288,841,shop,390,435,45
4289,841,work,435,975,540
4290,841,education,975,1080,105
4291,841,home,1080,1440,360
4292,842,home,0,390,390
4293,842,leisure,390,420,30
4294,842,work,420,990,570
4295,842,shop,990,1005,15
4296,842,home,1005,1440,435
4297,843,home,0,420,420
4298,843,work,420,945,525
4299,843,shop,945,960,15
4300,843,home,960,1440,480
4301,844,home,0,405,405
4302,844,shop,405,435,30
4303,844,work,435,915,480
4304,844,leisure,915,1005,90
4305,844,home,1005,1440,435
4306,845,home,0,375,375
4307,845,shop,375,420,45
4308,845,work,420,990,570
4309,845,home,990,1440,450
4310,846,home,0,375,375
4311,846,work,375,930,555
4312,846,leisure,930,990,60
4313,846,home,990,1440,450
4314,847,home,0,405,405
4315,847,work,405,960,555
4316,847,home,960,1230,270
4317,847,leisure,1230,1320,90
4318,847,home,1320,1440,120
4319,848,home,0,405,405
4320,848,work,405,960,555
4321,848,home,960,1440,480
4322,849,home,0,390,390
4323,849,work,390,780,390
4324,849,education,780,900,120
4325,849,shop,900,960,60
4326,849,home,960,1140,180
4327,849,leisure,1140,1200,60
4328,849,home,1200,1440,240
4329,850,home,0,405,405
4330,850,work,405,960,555
4331,850,leisure,960,1020,60
4332,850,home,1020,1440,420
4333,851,home,0,390,390
4334,851,work,390,960,570
4335,851,leisure,960,1020,60
4336,851,home,1020,1440,420
4337,852,home,0,375,375
4338,852,work,375,795,420
4339,852,education,795,945,150
4340,852,leisure,945,1005,60
4341,852,home,1005,1440,435
4342,853,home,0,375,375
4343,853,shop,375,390,15
4344,853,work,390,975,585
4345,853,shop,975,990,15
4346,853,home,990,1440,450
4347,854,home,0,390,390
4348,854,work,390,810,420
4349,854,education,810,1020,210
4350,854,home,1020,1440,420
4351,855,home,0,390,390
4352,855,work,390,975,585
4353,855,leisure,975,1050,75
4354,855,shop,1050,1065,15
4355,855,home,1065,1440,375
4356,856,home,0,420,420
4357,856,work,420,1005,585
4358,856,education,1005,1080,75
4359,856,home,1080,1440,360
4360,857,home,0,375,375
4361,857,shop,375,405,30
4362,857,education,405,525,120
4363,857,work,525,945,420
4364,857,leisure,945,1020,75
4365,857,home,1020,1440,420
4366,858,home,0,375,375
4367,858,shop,375,405,30
4368,858,work,405,930,525
4369,858,leisure,930,990,60
4370,858,home,990,1440,450
4371,859,home,0,375,375
4372,859,shop,375,390,15
4373,859,work,390,960,570
4374,859,leisure,960,1020,60
4375,859,home,1020,1440,420
4376,860,home,0,390,390
4377,860,leisure,390,420,30
4378,860,work,420,975,555
4379,860,leisure,975,1035,60
4380,860,home,1035,1440,405
4381,861,home,0,375,375
4382,861,work,375,975,600
4383,861,education,975,1080,105
4384,861,home,1080,1440,360
4385,862,home,0,375,375
4386,862,shop,375,420,45
4387,862,work,420,930,510
4388,862,shop,930,960,30
4389,862,home,960,1155,195
4390,862,leisure,1155,1215,60
4391,862,home,1215,1440,225
4392,863,home,0,375,375
4393,863,work,375,885,510
4394,863,shop,885,945,60
4395,863,home,945,1275,330
4396,863,leisure,1275,1335,60
4397,863,home,1335,1440,105
4398,864,home,0,375,375
4399,864,work,375,780,405
4400,864,education,780,960,180
4401,864,shop,960,975,15
4402,864,home,975,1095,120
4403,864,leisure,1095,1125,30
4404,864,home,1125,1440,315
4405,865,home,0,375,375
4406,865,leisure,375,405,30
4407,865,work,405,930,525
4408,865,shop,930,960,30
4409,865,home,960,1140,180
4410,865,leisure,1140,1200,60
4411,865,home,1200,1440,240
4412,866,home,0,390,390
4413,866,leisure,390,420,30
4414,866,work,420,975,555
4415,866,education,975,1080,105
4416,866,home,1080,1440,360
4417,867,home,0,375,375
4418,867,leisure,375,390,15
4419,867,work,390,915,525
4420,867,shop,915,960,45
4421,867,home,960,1440,480
4422,868,home,0,375,375
4423,868,shop,375,450,75
4424,868,work,450,1020,570
4425,868,education,1020,1080,60
4426,868,home,1080,1440,360
4427,869,home,0,375,375
4428,869,work,375,795,420
4429,869,education,795,930,135
4430,869,shop,930,960,30
4431,869,home,960,1440,480
4432,870,home,0,375,375
4433,870,shop,375,435,60
4434,870,work,435,990,555
4435,870,education,990,1080,90
4436,870,home,1080,1440,360
4437,871,home,0,375,375
4438,871,shop,375,390,15
4439,871,education,390,480,90
4440,871,work,480,1020,540
4441,871,leisure,1020,1095,75
4442,871,home,1095,1440,345
4443,872,home,0,375,375
4444,872,shop,375,390,15
4445,872,work,390,930,540
4446,872,leisure,930,975,45
4447,872,home,975,1155,180
4448,872,shop,1155,1170,15
4449,872,home,1170,1440,270
4450,873,home,0,405,405
4451,873,shop,405,420,15
4452,873,work,420,975,555
4453,873,education,975,1080,105
4454,873,home,1080,1440,360
4455,874,home,0,390,390
4456,874,shop,390,420,30
4457,874,work,420,930,510
4458,874,leisure,930,990,60
4459,874,home,990,1440,450
4460,875,home,0,390,390
4461,875,shop,390,420,30
4462,875,work,420,945,525
4463,875,leisure,945,1005,60
4464,875,home,1005,1440,435
4465,876,home,0,375,375
4466,876,shop,375,405,30
4467,876,work,405,825,420
4468,876,education,825,990,165
4469,876,home,990,1440,450
4470,877,home,0,375,375
4471,877,work,375,945,570
4472,877,shop,945,960,15
4473,877,home,960,1440,480
4474,878,home,0,390,390
4475,878,shop,390,420,30
4476,878,work,420,990,570
4477,878,leisure,990,1095,105
4478,878,home,1095,1440,345
4479,879,home,0,390,390
4480,879,shop,390,450,60
4481,879,work,450,960,510
4482,879,leisure,960,1080,120
4483,879,home,1080,1440,360
4484,880,home,0,390,390
4485,880,work,390,810,420
4486,880,education,810,975,165
4487,880,shop,975,990,15
4488,880,home,990,1440,450
4489,881,home,0,390,390
4490,881,work,390,975,585
4491,881,education,975,1080,105
4492,881,home,1080,1440,360
4493,882,home,0,375,375
4494,882,leisure,375,435,60
4495,882,work,435,1005,570
4496,882,education,1005,1080,75
4497,882,home,1080,1440,360
4498,883,home,0,375,375
4499,883,shop,375,435,60
4500,883,work,435,810,375
4501,883,education,810,990,180
4502,883,home,990,1170,180
4503,883,leisure,1170,1245,75
4504,883,home,1245,1440,195
4505,884,home,0,375,375
4506,884,shop,375,390,15
4507,884,education,390,465,75
4508,884,work,465,930,465
4509,884,leisure,930,1005,75
4510,884,shop,1005,1020,15
4511,884,home,1020,1440,420
4512,885,home,0,375,375
4513,885,work,375,990,615
4514,885,leisure,990,1065,75
4515,885,home,1065,1440,375
4516,886,home,0,375,375
4517,886,shop,375,405,30
4518,886,education,405,510,105
4519,886,work,510,1020,510
4520,886,leisure,1020,1065,45
4521,886,home,1065,1440,375
4522,887,home,0,375,375
4523,887,shop,375,435,60
4524,887,work,435,930,495
4525,887,leisure,930,1020,90
4526,887,home,1020,1440,420
4527,888,home,0,375,375
4528,888,shop,375,390,15
4529,888,work,390,900,510
4530,888,shop,900,960,60
4531,888,home,960,1440,480
4532,889,home,0,375,375
4533,889,shop,375,435,60
4534,889,work,435,945,510
4535,889,leisure,945,1035,90
4536,889,home,1035,1440,405
4537,890,home,0,405,405
4538,890,work,405,990,585
4539,890,education,990,1080,90
4540,890,home,1080,1440,360
4541,891,home,0,390,390
4542,891,work,390,960,570
4543,891,leisure,960,1035,75
4544,891,home,1035,1440,405
4545,892,home,0,390,390
4546,892,work,390,795,405
4547,892,education,795,1005,210
4548,892,home,1005,1440,435
4549,893,home,0,375,375
4550,893,work,375,885,510
4551,893,shop,885,960,75
4552,893,home,960,1275,315
4553,893,leisure,1275,1335,60
4554,893,home,1335,1440,105
4555,894,home,0,375,375
4556,894,shop,375,435,60
4557,894,leisure,435,480,45
4558,894,work,480,990,510
4559,894,home,990,1440,450
4560,895,home,0,375,375
4561,895,shop,375,450,75
4562,895,work,450,990,540
4563,895,leisure,990,1080,90
4564,895,home,1080,1440,360
4565,896,home,0,375,375
4566,896,shop,375,390,15
4567,896,work,390,990,600
4568,896,leisure,990,1065,75
4569,896,home,1065,1440,375
4570,897,home,0,405,405
4571,897,leisure,405,420,15
4572,897,work,420,1020,600
4573,897,leisure,1020,1110,90
4574,897,home,1110,1440,330
4575,898,home,0,375,375
4576,898,shop,375,390,15
4577,898,leisure,390,420,30
4578,898,work,420,975,555
4579,898,education,975,1080,105
4580,898,home,1080,1440,360
4581,899,home,0,390,390
4582,899,shop,390,420,30
4583,899,leisure,420,480,60
4584,899,work,480,945,465
4585,899,shop,945,960,15
4586,899,home,960,1440,480
4587,900,home,0,405,405
4588,900,work,405,825,420
4589,900,education,825,975,150
4590,900,shop,975,990,15
4591,900,home,990,1440,450
4592,901,home,0,435,435
4593,901,work,435,990,555
4594,901,leisure,990,1065,75
4595,901,home,1065,1440,375
4596,902,home,0,375,375
4597,902,shop,375,405,30
4598,902,work,405,960,555
4599,902,leisure,960,1035,75
4600,902,home,1035,1440,405
4601,903,home,0,405,405
4602,903,shop,405,450,45
4603,903,work,450,945,495
4604,903,leisure,945,1020,75
4605,903,home,1020,1440,420
4606,904,home,0,375,375
4607,904,shop,375,390,15
4608,904,work,390,930,540
4609,904,shop,930,960,30
4610,904,home,960,1440,480
4611,905,home,0,390,390
4612,905,leisure,390,450,60
4613,905,work,450,975,525
4614,905,shop,975,990,15
4615,905,home,990,1440,450
4616,906,home,0,375,375
4617,906,work,375,945,570
4618,906,shop,945,960,15
4619,906,home,960,1440,480
4620,907,home,0,405,405
4621,907,work,405,825,420
4622,907,shop,825,945,120
4623,907,home,945,1170,225
4624,907,leisure,1170,1245,75
4625,907,home,1245,1440,195
4626,908,home,0,405,405
4627,908,shop,405,420,15
4628,908,work,420,975,555
4629,908,education,975,1080,105
4630,908,home,1080,1440,360
4631,909,home,0,375,375
4632,909,work,375,990,615
4633,909,education,990,1080,90
4634,909,shop,1080,1095,15
4635,909,home,1095,1440,345
4636,910,home,0,375,375
4637,910,shop,375,435,60
4638,910,education,435,450,15
4639,910,work,450,990,540
4640,910,education,990,1080,90
4641,910,home,1080,1440,360
4642,911,home,0,375,375
4643,911,shop,375,420,45
4644,911,work,420,975,555
4645,911,leisure,975,1065,90
4646,911,home,1065,1440,375
4647,912,home,0,390,390
4648,912,leisure,390,450,60
4649,912,work,450,990,540
4650,912,shop,990,1005,15
4651,912,home,1005,1440,435
4652,913,home,0,375,375
4653,913,shop,375,435,60
4654,913,work,435,1005,570
4655,913,education,1005,1080,75
4656,913,home,1080,1440,360
4657,914,home,0,390,390
4658,914,shop,390,405,15
4659,914,work,405,945,540
4660,914,shop,945,960,15
4661,914,home,960,1440,480
4662,915,home,0,375,375
4663,915,leisure,375,435,60
4664,915,work,435,975,540
4665,915,education,975,1080,105
4666,915,home,1080,1440,360
4667,916,home,0,405,405
4668,916,work,405,960,555
4669,916,shop,960,975,15
4670,916,home,975,1155,180
4671,916,shop,1155,1170,15
4672,916,home,1170,1440,270
4673,917,home,0,435,435
4674,917,shop,435,450,15
4675,917,work,450,990,540
4676,917,leisure,990,1065,75
4677,917,home,1065,1440,375
4678,918,home,0,375,375
4679,918,work,375,885,510
4680,918,shop,885,945,60
4681,918,home,945,1440,495
4682,919,home,0,405,405
4683,919,work,405,975,570
4684,919,leisure,975,1035,60
4685,919,home,1035,1440,405
4686,920,home,0,390,390
4687,920,shop,390,420,30
4688,920,work,420,930,510
4689,920,leisure,930,1005,75
4690,920,home,1005,1440,435
4691,921,home,0,390,390
4692,921,work,390,870,480
4693,921,shop,870,960,90
4694,921,home,960,1440,480
4695,922,home,0,390,390
4696,922,shop,390,435,45
4697,922,education,435,540,105
4698,922,work,540,975,435
4699,922,leisure,975,1020,45
4700,922,home,1020,1440,420
4701,923,home,0,375,375
4702,923,shop,375,420,45
4703,923,work,420,975,555
4704,923,leisure,975,1110,135
4705,923,home,1110,1440,330
4706,924,home,0,375,375
4707,924,shop,375,405,30
4708,924,work,405,975,570
4709,924,leisure,975,1020,45
4710,924,home,1020,1440,420
4711,925,home,0,375,375
4712,925,work,375,795,420
4713,925,education,795,1020,225
4714,925,home,1020,1215,195
4715,925,leisure,1215,1245,30
4716,925,home,1245,1440,195
4717,926,home,0,375,375
4718,926,shop,375,420,45
4719,926,work,420,960,540
4720,926,leisure,960,1020,60
4721,926,home,1020,1440,420
4722,927,home,0,420,420
4723,927,shop,420,465,45
4724,927,work,465,960,495
4725,927,leisure,960,1005,45
4726,927,home,1005,1200,195
4727,927,leisure,1200,1260,60
4728,927,home,1260,1440,180
4729,928,home,0,390,390
4730,928,shop,390,450,60
4731,928,work,450,975,525
4732,928,education,975,1080,105
4733,928,home,1080,1440,360
4734,929,home,0,405,405
4735,929,work,405,990,585
4736,929,leisure,990,1020,30
4737,929,home,1020,1440,420
4738,930,home,0,405,405
4739,930,shop,405,420,15
4740,930,work,420,975,555
4741,930,education,975,1080,105
4742,930,home,1080,1440,360
4743,931,home,0,390,390
4744,931,work,390,990,600
4745,931,education,990,1080,90
4746,931,home,1080,1440,360
4747,932,home,0,405,405
4748,932,shop,405,435,30
4749,932,work,435,885,450
4750,932,home,885,1080,195
4751,932,shop,1080,1095,15
4752,932,home,1095,1440,345
4753,933,home,0,390,390
4754,933,shop,390,435,45
4755,933,leisure,435,495,60
4756,933,work,495,1005,510
4757,933,education,1005,1080,75
4758,933,home,1080,1440,360
4759,934,home,0,420,420
4760,934,shop,420,465,45
4761,934,work,465,990,525
4762,934,education,990,1080,90
4763,934,home,1080,1440,360
4764,935,home,0,375,375
4765,935,shop,375,435,60
4766,935,work,435,990,555
4767,935,education,990,1080,90
4768,935,home,1080,1440,360
4769,936,home,0,375,375
4770,936,shop,375,435,60
4771,936,work,435,975,540
4772,936,leisure,975,1050,75
4773,936,home,1050,1440,390
4774,937,home,0,405,405
4775,937,leisure,405,435,30
4776,937,work,435,1020,585
4777,937,education,1020,1080,60
4778,937,home,1080,1440,360
4779,938,home,0,420,420
4780,938,work,420,990,570
4781,938,leisure,990,1080,90
4782,938,home,1080,1440,360
4783,939,home,0,375,375
4784,939,shop,375,390,15
4785,939,work,390,840,450
4786,939,home,840,1035,195
4787,939,shop,1035,1050,15
4788,939,home,1050,1440,390
4789,940,home,0,375,375
4790,940,shop,375,390,15
4791,940,work,390,810,420
4792,940,education,810,1005,195
4793,940,home,1005,1440,435
4794,941,home,0,420,420
4795,941,shop,420,450,30
4796,941,work,450,945,495
4797,941,leisure,945,1035,90
4798,941,home,1035,1440,405
4799,942,home,0,375,375
4800,942,work,375,930,555
4801,942,leisure,930,990,60
4802,942,home,990,1440,450
4803,943,home,0,390,390
4804,943,work,390,1005,615
4805,943,leisure,1005,1155,150
4806,943,home,1155,1440,285
4807,944,home,0,420,420
4808,944,shop,420,450,30
4809,944,work,450,960,510
4810,944,leisure,960,1035,75
4811,944,home,1035,1440,405
4812,945,home,0,375,375
4813,945,shop,375,405,30
4814,945,work,405,915,510
4815,945,shop,915,960,45
4816,945,home,960,1440,480
4817,946,home,0,375,375
4818,946,work,375,795,420
4819,946,education,795,915,120
4820,946,leisure,915,975,60
4821,946,home,975,1440,465
4822,947,home,0,390,390
4823,947,leisure,390,420,30
4824,947,work,420,930,510
4825,947,leisure,930,960,30
4826,947,shop,960,975,15
4827,947,home,975,1440,465
4828,948,home,0,390,390
4829,948,leisure,390,405,15
4830,948,work,405,930,525
4831,948,shop,930,960,30
4832,948,home,960,1140,180
4833,948,leisure,1140,1200,60
4834,948,home,1200,1440,240
4835,949,home,0,405,405
4836,949,work,405,930,525
4837,949,leisure,930,990,60
4838,949,home,990,1005,15
4839,949,shop,1005,1020,15
4840,949,home,1020,1440,420
4841,950,home,0,375,375
4842,950,shop,375,420,45
4843,950,work,420,990,570
4844,950,leisure,990,1050,60
4845,950,home,1050,1440,390
4846,951,home,0,375,375
4847,951,shop,375,435,60
4848,951,work,435,915,480
4849,951,leisure,915,975,60
4850,951,home,975,1440,465
4851,952,home,0,390,390
4852,952,work,390,900,510
4853,952,home,900,1140,240
4854,952,leisure,1140,1200,60
4855,952,home,1200,1440,240
4856,953,home,0,375,375
4857,953,shop,375,435,60
4858,953,work,435,975,540
4859,953,education,975,1080,105
4860,953,home,1080,1440,360
4861,954,home,0,420,420
4862,954,shop,420,450,30
4863,954,work,450,930,480
4864,954,leisure,930,990,60
4865,954,home,990,1440,450
4866,955,home,0,375,375
4867,955,shop,375,420,45
4868,955,home,420,555,135
4869,955,work,555,975,420
4870,955,shop,975,990,15
4871,955,home,990,1440,450
4872,956,home,0,390,390
4873,956,work,390,915,525
4874,956,leisure,915,990,75
4875,956,home,990,1440,450
4876,957,home,0,435,435
4877,957,shop,435,450,15
4878,957,work,450,960,510
4879,957,leisure,960,1035,75
4880,957,home,1035,1440,405
4881,958,home,0,390,390
4882,958,work,390,945,555
4883,958,shop,945,960,15
4884,958,home,960,1440,480
4885,959,home,0,375,375
4886,959,shop,375,405,30
4887,959,work,405,960,555
4888,959,home,960,1200,240
4889,959,leisure,1200,1260,60
4890,959,home,1260,1440,180
4891,960,home,0,405,405
4892,960,shop,405,465,60
4893,960,leisure,465,495,30
4894,960,work,495,960,465
4895,960,leisure,960,1020,60
4896,960,home,1020,1440,420
4897,961,home,0,405,405
4898,961,shop,405,435,30
4899,961,education,435,540,105
4900,961,work,540,990,450
4901,961,leisure,990,1050,60
4902,961,home,1050,1440,390
4903,962,home,0,375,375
4904,962,shop,375,405,30
4905,962,work,405,915,510
4906,962,leisure,915,990,75
4907,962,home,990,1440,450
4908,963,home,0,390,390
4909,963,leisure,390,405,15
4910,963,work,405,945,540
4911,963,leisure,945,1005,60
4912,963,home,1005,1440,435
4913,964,home,0,405,405
4914,964,work,405,825,420
4915,964,shop,825,900,75
4916,964,home,900,1065,165
4917,964,leisure,1065,1080,15
4918,964,home,1080,1440,360
4919,965,home,0,375,375
4920,965,work,375,795,420
4921,965,shop,795,945,150
4922,965,home,945,1440,495
4923,966,home,0,375,375
4924,966,shop,375,390,15
4925,966,work,390,825,435
4926,966,education,825,1020,195
4927,966,home,1020,1440,420
4928,967,home,0,375,375
4929,967,shop,375,420,45
4930,967,work,420,930,510
4931,967,leisure,930,1005,75
4932,967,home,1005,1440,435
4933,968,home,0,390,390
4934,968,shop,390,435,45
4935,968,work,435,1020,585
4936,968,education,1020,1080,60
4937,968,home,1080,1440,360
4938,969,home,0,375,375
4939,969,shop,375,405,30
4940,969,work,405,960,555
4941,969,leisure,960,990,30
4942,969,home,990,1440,450
4943,970,home,0,435,435
4944,970,shop,435,465,30
4945,970,work,465,1005,540
4946,970,education,1005,1080,75
4947,970,shop,1080,1095,15
4948,970,home,1095,1440,345
4949,971,home,0,375,375
4950,971,shop,375,420,45
4951,971,education,420,540,120
4952,971,work,540,960,420
4953,971,leisure,960,1020,60
4954,971,home,1020,1440,420
4955,972,home,0,375,375
4956,972,shop,375,420,45
4957,972,work,420,975,555
4958,972,shop,975,990,15
4959,972,home,990,1245,255
4960,972,leisure,1245,1260,15
4961,972,home,1260,1440,180
4962,973,home,0,375,375
4963,973,leisure,375,390,15
4964,973,work,390,810,420
4965,973,education,810,1080,270
4966,973,home,1080,1440,360
4967,974,home,0,390,390
4968,974,leisure,390,450,60
4969,974,work,450,885,435
4970,974,shop,885,960,75
4971,974,home,960,1440,480
4972,975,home,0,375,375
4973,975,work,375,810,435
4974,975,education,810,945,135
4975,975,shop,945,960,15
4976,975,home,960,1440,480
4977,976,home,0,390,390
4978,976,work,390,915,525
4979,976,shop,915,960,45
4980,976,home,960,1140,180
4981,976,leisure,1140,1200,60
4982,976,home,1200,1440,240
4983,977,home,0,375,375
4984,977,leisure,375,420,45
4985,977,work,420,990,570
4986,977,leisure,990,1110,120
4987,977,shop,1110,1125,15
4988,977,home,1125,1440,315
4989,978,home,0,405,405
4990,978,work,405,945,540
4991,978,leisure,945,1020,75
4992,978,home,1020,1440,420
4993,979,home,0,375,375
4994,979,shop,375,420,45
4995,979,work,420,945,525
4996,979,leisure,945,1065,120
4997,979,home,1065,1440,375
4998,980,home,0,405,405
4999,980,leisure,405,465,60
5000,980,work,465,915,450
5001,980,shop,915,960,45
5002,980,home,960,1440,480
5003,981,home,0,390,390
5004,981,work,390,825,435
5005,981,education,825,990,165
5006,981,home,990,1140,150
5007,981,shop,1140,1155,15
5008,981,home,1155,1440,285
5009,982,home,0,375,375
5010,982,work,375,810,435
5011,982,education,810,1005,195
5012,982,home,1005,1200,195
5013,982,leisure,1200,1275,75
5014,982,home,1275,1440,165
5015,983,home,0,375,375
5016,983,work,375,1005,630
5017,983,education,1005,1080,75
5018,983,home,1080,1440,360
5019,984,home,0,375,375
5020,984,shop,375,390,15
5021,984,leisure,390,450,60
5022,984,work,450,1005,555
5023,984,education,1005,1080,75
5024,984,home,1080,1440,360
5025,985,home,0,375,375
5026,985,shop,375,405,30
5027,985,work,405,825,420
5028,985,education,825,1035,210
5029,985,home,1035,1440,405
5030,986,home,0,375,375
5031,986,shop,375,390,15
5032,986,work,390,1020,630
5033,986,leisure,1020,1095,75
5034,986,home,1095,1440,345
5035,987,home,0,375,375
5036,987,work,375,795,420
5037,987,shop,795,960,165
5038,987,home,960,1440,480
5039,988,home,0,375,375
5040,988,work,375,795,420
5041,988,shop,795,870,75
5042,988,education,870,1035,165
5043,988,home,1035,1440,405
5044,989,home,0,390,390
5045,989,shop,390,450,60
5046,989,education,450,555,105
5047,989,work,555,1020,465
5048,989,education,1020,1080,60
5049,989,home,1080,1440,360
5050,990,home,0,375,375
5051,990,shop,375,420,45
5052,990,work,420,930,510
5053,990,leisure,930,990,60
5054,990,home,990,1440,450
5055,991,home,0,375,375
5056,991,work,375,990,615
5057,991,shop,990,1005,15
5058,991,home,1005,1440,435
5059,992,home,0,390,390
5060,992,shop,390,450,60
5061,992,education,450,555,105
5062,992,work,555,1080,525
5063,992,leisure,1080,1155,75
5064,992,home,1155,1440,285
5065,993,home,0,405,405
5066,993,shop,405,450,45
5067,993,work,450,975,525
5068,993,education,975,1080,105
5069,993,home,1080,1440,360
5070,994,home,0,390,390
5071,994,work,390,990,600
5072,994,home,990,1440,450
5073,995,home,0,375,375
5074,995,work,375,780,405
5075,995,education,780,915,135
5076,995,shop,915,960,45
5077,995,home,960,1440,480
5078,996,home,0,390,390
5079,996,shop,390,420,30
5080,996,work,420,930,510
5081,996,leisure,930,1005,75
5082,996,home,1005,1440,435
5083,997,home,0,375,375
5084,997,shop,375,390,15
5085,997,work,390,825,435
5086,997,education,825,1020,195
5087,997,home,1020,1440,420
5088,998,home,0,375,375
5089,998,work,375,975,600
5090,998,shop,975,990,15
5091,998,home,990,1440,450
5092,999,home,0,390,390
5093,999,work,390,810,420
5094,999,education,810,930,120
5095,999,leisure,930,1050,120
5096,999,home,1050,1440,390
